ACS Applied Materials & Interfaces	ACS Appl. Mater. Interfaces
ACS Biomaterials Science & Engineering	ACS Biomater. Sci. Eng.
ACS Catalysis	ACS Catal.
ACS Central Science	ACS Cent. Sci.
ACS Chemical Biology	ACS Chem. Biol.
ACS Chemical Neuroscience	ACS Chem. Neurosci.
ACS Combinatorial Science	ACS Comb. Sci.
ACS Infectious Diseases	ACS Infect. Dis.
ACS Macro Letters	ACS Macro Lett.
ACS Medicinal Chemistry Letters	ACS Med. Chem. Lett.
	ACS Nano
	ACS Photonics
ACS Sensors	ACS Sens.
ACS Sustainable Chemistry & Engineering	ACS Sustainable Chem. Eng.
ACS Symposium Series	ACS Symp. Ser.
ACS Synthetic Biology	ACS Synth. Biol.
AIChE Journal	AIChE J.
APL Materials	APL Mater.
ARKIVOC (Gainesville, FL, United States)	ARKIVOC (Gainesville, FL, U. S.)
Accounts of Chemical Research	Acc. Chem. Res.
Acta Biochimica Polonica	Acta Biochim. Pol.
Acta Chimica Slovaca	Acta Chim. Slovaca
Acta Chimica Slovenica	Acta Chim. Slov.
Acta Crystallographica, Section A: Foundations and Advances	Acta Crystallogr., Sect. A: Found. Adv.
Acta Crystallographica, Section B: Structural Science, Crystal Engineering and Materials	Acta Crystallogr., Sect. B: Struct. Sci., Cryst. Eng. Mater.
Acta Crystallographica, Section C: Structural Chemistry	Acta Crystallogr., Sect. C: Struct. Chem.
Acta Crystallographica, Section D: Biological Crystallography	Acta Crystallogr., Sect. D: Biol. Crystallogr.
Acta Crystallographica, Section E: Crystallographic Communications	Acta Crystallogr., Sect. E: Crystallogr. Commun.
Acta Crystallographica, Section F: Structural Biology Communications	Acta Crystallogr., Sect. F: Struct. Biol. Commun.
Acta Materialia	Acta Mater.
Acta Pharmaceutica (Zagreb, Croatia)	Acta Pharm. (Zagreb, Croatia)
Acta Pharmacologica Sinica	Acta Pharmacol. Sin.
Acta Physica Polonica A	Acta Phys. Pol. A
Acta Physiologica	Acta Physiol.
	Adsorption
Adsorption Science & Technology	Adsorpt. Sci. Technol.
Advanced Drug Delivery Reviews	Adv. Drug Delivery Rev.
Advanced Electronic Materials	Adv. Electron. Mater.
Advanced Energy Materials	Adv. Energy Mater.
Advanced Functional Materials	Adv. Funct. Mater.
Advanced Healthcare Materials	Adv. Healthcare Mater.
Advanced Materials (Weinheim, Germany)	Adv. Mater. (Weinheim, Ger.)
Advanced Optical Materials	Adv. Opt. Mater.
Advanced Synthesis & Catalysis	Adv. Synth. Catal.
Advances in Applied Ceramics	Adv. Appl. Ceram.
Advances in Chemical Physics	Adv. Chem. Phys.
Advances in Chromatography (Boca Raton, FL, United States)	Adv. Chromatogr. (Boca Raton, FL, U. S.)
Advances in Colloid and Interface Science	Adv. Colloid Interface Sci.
Advances in Electrochemical Science and Engineering	Adv. Electrochem. Sci. Eng.
Advances in Enzyme Research	Adv. Enzyme Res.
Advances in Inorganic Chemistry	Adv. Inorg. Chem.
Advances in Polymer Science	Adv. Polym. Sci.
Advances in Polymer Technology	Adv. Polym. Technol.
Advances in X-Ray Analysis	Adv. X-Ray Anal.
Aerosol Science and Technology	Aerosol Sci. Technol.
	Afinidad
	Aging Cell
American Ceramic Society Bulletin	Am. Ceram. Soc. Bull.
American Chemical Science Journal	Am. Chem. Sci. J.
American Journal of Clinical Nutrition	Am. J. Clin. Nutr.
American Journal of Human Genetics	Am. J. Hum. Genet.
American Journal of Physiology	Am. J. Physiol.
American Journal of Respiratory Cell and Molecular Biology	Am. J. Respir. Cell Mol. Biol.
	Amino Acids
Analyst (Cambridge, United Kingdom)	Analyst (Cambridge, U. K.)
Analytica Chimica Acta	Anal. Chim. Acta
Analytical Biochemistry	Anal. Biochem.
Analytical Chemistry (Washington, DC, United States)	Anal. Chem. (Washington, DC, U. S.)
Analytical Chemistry Letters	Anal. Chem. Lett.
Analytical Letters	Anal. Lett.
Analytical Sciences	Anal. Sci.
Analytical and Bioanalytical Chemistry	Anal. Bioanal. Chem.
Angewandte Chemie, International Edition	Angew. Chem., Int. Ed.
Annales Pharmaceutiques Francaises	Ann. Pharm. Fr.
Annales de Chimie (Cachan, France)	Ann. Chim. (Cachan, Fr.)
Annals of Nuclear Energy	Ann. Nucl. Energy
Annals of Nutrition & Metabolism	Ann. Nutr. Metab.
Annals of Physics (Amsterdam, Netherlands)	Ann. Phys. (Amsterdam, Neth.)
Annals of Plastic Surgery	Ann. Plast. Surg.
Annual Review of Biochemistry	Annu. Rev. Biochem.
Annual Review of Biomedical Engineering	Annu. Rev. Biomed. Eng.
Annual Review of Biophysics	Annu. Rev. Biophys.
Annual Review of Cell and Developmental Biology	Annu. Rev. Cell Dev. Biol.
Annual Review of Earth and Planetary Sciences	Annu. Rev. Earth Planet. Sci.
Annual Review of Entomology	Annu. Rev. Entomol.
Annual Review of Genetics	Annu. Rev. Genet.
Annual Review of Genomics and Human Genetics	Annu. Rev. Genomics Hum. Genet.
Annual Review of Immunology	Annu. Rev. Immunol.
Annual Review of Materials Research	Annu. Rev. Mater. Res.
Annual Review of Medicine	Annu. Rev. Med.
Annual Review of Microbiology	Annu. Rev. Microbiol.
Annual Review of Neuroscience	Annu. Rev. Neurosci.
Annual Review of Nuclear and Particle Science	Annu. Rev. Nucl. Part. Sci.
Annual Review of Nutrition	Annu. Rev. Nutr.
Annual Review of Pathology: Mechanisms of Disease	Annu. Rev. Pathol.: Mech. Dis.
Annual Review of Pharmacology and Toxicology	Annu. Rev. Pharmacol. Toxicol.
Annual Review of Physical Chemistry	Annu. Rev. Phys. Chem.
Annual Review of Physiology	Annu. Rev. Physiol.
Annual Review of Phytopathology	Annu. Rev. Phytopathol.
Annual Review of Plant Biology	Annu. Rev. Plant Biol.
Annual Review of Virology	Annu. Rev. Virol.
Anti-Cancer Agents in Medicinal Chemistry	Anti-Cancer Agents Med. Chem.
	Anti-Cancer Drugs
Anti-Infective Agents	Anti-Infect. Agents
Anti-Inflammatory & Anti-Allergy Agents in Medicinal Chemistry	Anti-Inflammatory Anti-Allergy Agents Med. Chem.
Antibiotics (Basel, Switzerland)	Antibiotics (Basel, Switz.)
Antibiotiki i Khimioterapiya	Antibiot. Khimioter.
Antimicrobial Agents and Chemotherapy	Antimicrob. Agents Chemother.
	Antioxidants
Antioxidants & Redox Signaling	Antioxid. Redox Signaling
Antiviral Research	Antiviral Res.
Applied Biochemistry and Biotechnology	Appl. Biochem. Biotechnol.
Applied Biochemistry and Microbiology	Appl. Biochem. Microbiol.
Applied Catalysis, A: General	Appl. Catal., A
Applied Catalysis, B: Environmental	Appl. Catal., B
Applied Clay Science	Appl. Clay Sci.
Applied Geochemistry	Appl. Geochem.
Applied Microbiology and Biotechnology	Appl. Microbiol. Biotechnol.
Applied Nanoscience	Appl. Nanosci.
Applied Organometallic Chemistry	Appl. Organomet. Chem.
Applied Physics A: Materials Science & Processing	Appl. Phys. A: Mater. Sci. Process.
Applied Physics B: Lasers and Optics	Appl. Phys. B: Lasers Opt.
Applied Physics Express	Appl. Phys. Express
Applied Physics Letters	Appl. Phys. Lett.
Applied Physics Reviews	Appl. Phys. Rev.
Applied Radiation and Isotopes	Appl. Radiat. Isot.
Applied Spectroscopy	Appl. Spectrosc.
Applied Surface Science	Appl. Surf. Sci.
Applied and Environmental Microbiology	Appl. Environ. Microbiol.
Aquatic Toxicology	Aquat. Toxicol.
	Archaea
Archiv der Pharmazie (Weinheim, Germany)	Arch. Pharm. (Weinheim, Ger.)
Archives of Biochemistry and Biophysics	Arch. Biochem. Biophys.
Archives of Environmental Contamination and Toxicology	Arch. Environ. Contam. Toxicol.
Archives of Insect Biochemistry and Physiology	Arch. Insect Biochem. Physiol.
Archives of Microbiology	Arch. Microbiol.
Archives of Pharmacal Research	Arch. Pharmacal Res.
Archives of Physiology and Biochemistry	Arch. Physiol. Biochem.
Archives of Toxicology	Arch. Toxicol.
Archives of Virology	Arch. Virol.
Arteriosclerosis, Thrombosis, and Vascular Biology	Arterioscler., Thromb., Vasc. Biol.
Asia-Pacific Journal of Chemical Engineering	Asia-Pac. J. Chem. Eng.
Asian Journal of Chemistry	Asian J. Chem.
Asian Journal of Organic Chemistry	Asian J. Org. Chem.
Assay and Drug Development Technologies	Assay Drug Dev. Technol.
Atherosclerosis (Amsterdam, Netherlands)	Atherosclerosis (Amsterdam, Neth.)
Atmospheric Chemistry and Physics	Atmos. Chem. Phys.
Atmospheric Environment	Atmos. Environ.
Atomic Energy (New York, NY, United States)	At. Energy (N. Y., NY, U. S.)
Atomic Spectroscopy	At. Spectrosc.
Australian Journal of Chemistry	Aust. J. Chem.
Autonomic & Autacoid Pharmacology	Auton. Autacoid Pharmacol.
Azerbaidzhanskii Khimicheskii Zhurnal	Azerb. Khim. Zh.
BMB Reports	BMB Rep.
Basic & Clinical Pharmacology & Toxicology	Basic Clin. Pharmacol. Toxicol.
Beilstein Journal of Nanotechnology	Beilstein J. Nanotechnol.
Beilstein Journal of Organic Chemistry	Beilstein J. Org. Chem.
BioChemistry: An Indian Journal	BioChem.: Indian J.
BioChip Journal	BioChip J.
	BioFactors
BioInorganic Reaction Mechanisms	BioInorg. React. Mech.
	BioMetals
	BioResources
	BioTechniques
Bioactive Carbohydrates and Dietary Fibre	Bioact. Carbohydr. Diet. Fibre
	Bioanalysis
Biocatalysis and Biotransformation	Biocatal. Biotransform.
Biochemical Genetics	Biochem. Genet.
Biochemical Journal	Biochem. J.
Biochemical Pharmacology (Amsterdam, Netherlands)	Biochem. Pharmacol. (Amsterdam, Neth.)
Biochemical Society Transactions	Biochem. Soc. Trans.
Biochemical Systematics and Ecology	Biochem. Syst. Ecol.
Biochemical and Biophysical Research Communications	Biochem. Biophys. Res. Commun.
	Biochemistry
	Biochemistry (Moscow)
Biochemistry and Cell Biology	Biochem. Cell Biol.
Biochemistry and Molecular Biology Education	Biochem. Mol. Biol. Educ.
Biochimica et Biophysica Acta, Bioenergetics	Biochim. Biophys. Acta, Bioenerg.
Biochimica et Biophysica Acta, Biomembranes	Biochim. Biophys. Acta, Biomembr.
Biochimica et Biophysica Acta, Gene Regulatory Mechanisms	Biochim. Biophys. Acta, Gene Regul. Mech.
Biochimica et Biophysica Acta, General Subjects	Biochim. Biophys. Acta, Gen. Subj.
Biochimica et Biophysica Acta, Molecular Basis of Disease	Biochim. Biophys. Acta, Mol. Basis Dis.
Biochimica et Biophysica Acta, Molecular Cell Research	Biochim. Biophys. Acta, Mol. Cell Res.
Biochimica et Biophysica Acta, Molecular and Cell Biology of Lipids	Biochim. Biophys. Acta, Mol. Cell Biol. Lipids
Biochimica et Biophysica Acta, Proteins and Proteomics	Biochim. Biophys. Acta, Proteins Proteomics
Biochimica et Biophysica Acta, Reviews on Cancer	Biochim. Biophys. Acta, Rev. Cancer
	Biochimie
Bioconjugate Chemistry	Bioconjugate Chem.
	Bioelectrochemistry
	Biofuels
Biofuels, Bioproducts & Biorefining	Biofuels, Bioprod. Biorefin.
Biogenic Amines	Biog. Amines
	Bioinformatics
Bioinorganic Chemistry and Applications	Bioinorg. Chem. Appl.
Biological & Pharmaceutical Bulletin	Biol. Pharm. Bull.
Biological Chemistry	Biol. Chem.
Biological Trace Element Research	Biol. Trace Elem. Res.
Biologicheskie Membrany	Biol. Membr.
Biology of Reproduction	Biol. Reprod.
Biomacromolecular Mass Spectrometry	Biomacromol. Mass Spectrom.
	Biomacromolecules
	Biomarkers
Biomarkers in Medicine	Biomarkers Med.
	Biomaterials
Biomaterials Science	Biomater. Sci.
Biomedical Chromatography	Biomed. Chromatogr.
Biomedical Materials (Bristol, United Kingdom)	Biomed. Mater. (Bristol, U. K.)
Biomedical Research	Biomed. Res.
Biomeditsinskaya Khimiya	Biomed. Khim.
Biomolecular Concepts	Biomol. Concepts
Biomolecular NMR Assignments	Biomol. NMR Assignments
	Biomolecules
Bioorganic & Medicinal Chemistry	Bioorg. Med. Chem.
Bioorganic & Medicinal Chemistry Letters	Bioorg. Med. Chem. Lett.
Bioorganic Chemistry	Bioorg. Chem.
Biopharmaceutics & Drug Disposition	Biopharm. Drug Dispos.
Biophysical Chemistry	Biophys. Chem.
Biophysical Journal	Biophys. J.
Biophysics (English Translation)	Biophysics (Engl. Transl.)
	Biopolymers
Bioprocess and Biosystems Engineering	Bioprocess Biosyst. Eng.
Bioresource Technology	Bioresour. Technol.
Bioscience Reports	Biosci. Rep.
Bioscience, Biotechnology, and Biochemistry	Biosci., Biotechnol., Biochem.
Biosensors & Bioelectronics	Biosens. Bioelectron.
Biotechnology Journal	Biotechnol. J.
Biotechnology Letters	Biotechnol. Lett.
Biotechnology Progress	Biotechnol. Prog.
Biotechnology and Applied Biochemistry	Biotechnol. Appl. Biochem.
Biotechnology and Bioengineering	Biotechnol. Bioeng.
Biotechnology and Bioprocess Engineering	Biotechnol. Bioprocess Eng.
Birth Defects Research, Part A: Clinical and Molecular Teratology	Birth Defects Res., Part A
Birth Defects Research, Part B: Developmental and Reproductive Toxicology	Birth Defects Res., Part B
Birth Defects Research, Part C: Embryo Today--Reviews	Birth Defects Res., Part C
	Bitamin
	Blood
Bone Research	Bone Res.
	Bopuxue Zazhi
BrJAC--Brazilian Journal of Analytical Chemistry	BrJAC--Braz. J. Anal. Chem.
Brain Research	Brain Res.
Breast Cancer Management	Breast Cancer Manage.
British Journal of Nutrition	Br. J. Nutr.
British Journal of Pharmacology	Br. J. Pharmacol.
Bulletin of Environmental Contamination and Toxicology	Bull. Environ. Contam. Toxicol.
Bulletin of Materials Science	Bull. Mater. Sci.
Bulletin of the Chemical Society of Japan	Bull. Chem. Soc. Jpn.
Bulletin of the Korean Chemical Society	Bull. Korean Chem. Soc.
Bulletin of the Russian Academy of Sciences: Physics	Bull. Russ. Acad. Sci.: Phys.
	Bunseki Kagaku
	CALPHAD: Comput. Coupling Phase Diagrams Thermochem.
	CALPHAD: Computer Coupling of Phase Diagrams and Thermochemistry
CNS & Neurological Disorders: Drug Targets	CNS Neurol. Disord.: Drug Targets
CNS Oncology	CNS Oncol.
CPT: Pharmacometrics & Systems Pharmacology	CPT: Pharmacometrics Syst. Pharmacol.
	Cailiao Rechuli Xuebao
Calcified Tissue International	Calcif. Tissue Int.
Canadian Journal of Chemical Engineering	Can. J. Chem. Eng.
Canadian Journal of Chemistry	Can. J. Chem.
Canadian Journal of Microbiology	Can. J. Microbiol.
Canadian Journal of Physics	Can. J. Phys.
Canadian Journal of Physiology and Pharmacology	Can. J. Physiol. Pharmacol.
Canadian Metallurgical Quarterly	Can. Metall. Q.
Canadian Mineralogist	Can. Mineral.
	Cancer Cell
Cancer Gene Therapy	Cancer Gene Ther.
Cancer Genomics & Proteomics	Cancer Genomics Proteomics
Cancer Letters (New York, NY, United States)	Cancer Lett. (N. Y., NY, U. S.)
Cancer Research	Cancer Res.
Cancer Science	Cancer Sci.
Carbohydrate Polymers	Carbohydr. Polym.
Carbohydrate Research	Carbohydr. Res.
	Carbon
Carbon Management	Carbon Manage.
	Carcinogenesis
Cardiovascular & Hematological Agents in Medicinal Chemistry	Cardiovasc. Hematol. Agents Med. Chem.
Cardiovascular & Hematological Disorders: Drug Targets	Cardiovasc. Hematol. Disord.: Drug Targets
Cardiovascular Research	Cardiovasc. Res.
Catalysis Communications	Catal. Commun.
Catalysis Letters	Catal. Lett.
Catalysis Reviews: Science and Engineering	Catal. Rev.: Sci. Eng.
Catalysis Science & Technology	Catal. Sci. Technol.
Catalysis Today	Catal. Today
	Catalysts
Cell (Cambridge, MA, United States)	Cell (Cambridge, MA, U. S.)
Cell Biochemistry and Biophysics	Cell Biochem. Biophys.
Cell Biochemistry and Function	Cell Biochem. Funct.
	Cell Calcium
	Cell Cycle
Cell Host & Microbe	Cell Host Microbe
Cell Metabolism	Cell Metab.
Cell Reports	Cell Rep.
	Cell Stem Cell
Cellular Immunology	Cell. Immunol.
Cellular Microbiology	Cell. Microbiol.
Cellular Physiology and Biochemistry	Cell. Physiol. Biochem.
Cellular Polymers	Cell. Polym.
Cellular Reprogramming	Cell. Reprogram.
Cellular and Molecular Life Sciences	Cell. Mol. Life Sci.
Cellulose Chemistry and Technology	Cellul. Chem. Technol.
Cement & Concrete Composites	Cem. Concr. Compos.
Cement and Concrete Research	Cem. Concr. Res.
Central Nervous System Agents in Medicinal Chemistry	Cent. Nerv. Syst. Agents Med. Chem.
Ceramics International	Ceram. Int.
Ceramics-Silikaty	Ceram.-Silik.
Cereal Chemistry	Cereal Chem.
Ceska a Slovenska Farmacie	Ceska Slov. Farm.
	ChemBioChem
	ChemCatChem
	ChemElectroChem
	ChemMedChem
	ChemNanoMat
	ChemPhysChem
	ChemPlusChem
	ChemSusChem
Chemica Sinica	Chem. Sin.
Chemical & Pharmaceutical Bulletin	Chem. Pharm. Bull.
Chemical Biology & Drug Design	Chem. Biol. Drug Des.
Chemical Communications (Cambridge, United Kingdom)	Chem. Commun. (Cambridge, U. K.)
Chemical Engineering & Technology	Chem. Eng. Technol.
Chemical Engineering Communications	Chem. Eng. Commun.
Chemical Engineering Journal (Amsterdam, Netherlands)	Chem. Eng. J. (Amsterdam, Neth.)
Chemical Engineering Research and Design	Chem. Eng. Res. Des.
Chemical Engineering Research and Design	Chem. Eng. Sci.
Chemical Engineering and Processing	Chem. Eng. Process.
Chemical Geology	Chem. Geol.
Chemical Papers	Chem. Pap.
Chemical Physics	Chem. Phys.
Chemical Physics Letters	Chem. Phys. Lett.
Chemical Record	Chem. Rec.
Chemical Research in Chinese Universities	Chem. Res. Chin. Univ.
Chemical Research in Toxicology	Chem. Res. Toxicol.
Chemical Reviews (Washington, DC, United States)	Chem. Rev. (Washington, DC, U. S.)
Chemical Science	Chem. Sci.
Chemical Science Transactions	Chem. Sci. Trans.
Chemical Speciation and Bioavailability	Chem. Speciation Bioavailability
Chemical and Biochemical Engineering Quarterly	Chem. Biochem. Eng. Q.
Chemicke Listy	Chem. Listy
Chemico-Biological Interactions	Chem.-Biol. Interact.
Chemie Ingenieur Technik	Chem. Ing. Tech.
Chemie der Erde	Chem. Erde
	Chemija
Chemine Technologija (Kaunas, Lithuania)	Chem. Technol. (Kaunas, Lith.)
Chemistry & Biodiversity	Chem. Biodiversity
Chemistry & Biology (Oxford, United Kingdom)	Chem. Biol. (Oxford, U. K.)
Chemistry & Biology Interface	Chem. Biol. Interface
Chemistry & Industry (Chichester, United Kingdom)	Chem. Ind. (Chichester, U. K.)
Chemistry - A European Journal	Chem. - Eur. J.
Chemistry - An Asian Journal	Chem. - Asian J.
Chemistry Journal of Moldova	Chem. J. Mold.
Chemistry Letters	Chem. Lett.
Chemistry and Physics of Lipids	Chem. Phys. Lipids
Chemistry and Technology of Fuels and Oils	Chem. Technol. Fuels Oils
Chemistry of Heterocyclic Compounds (New York, NY, United States)	Chem. Heterocycl. Compd. (N. Y., NY, U. S.)
Chemistry of Materials	Chem. Mater.
Chemistry of Natural Compounds	Chem. Nat. Compd.
	ChemistryOpen
Chemometrics and Intelligent Laboratory Systems	Chemom. Intell. Lab. Syst.
	Chemosphere
Chemotherapy (Basel, Switzerland)	Chemotherapy (Basel, Switz.)
	Chimia
Chimica e l'Industria (Milan, Italy)	Chim. Ind. (Milan, Italy)
Chinese Chemical Letters	Chin. Chem. Lett.
Chinese Journal of Chemical Engineering	Chin. J. Chem. Eng.
Chinese Journal of Chemical Physics	Chin. J. Chem. Phys.
Chinese Journal of Chemistry	Chin. J. Chem.
Chinese Journal of Geochemistry	Chin. J. Geochem.
Chinese Journal of Polymer Science	Chin. J. Polym. Sci.
Chinese Journal of Structural Chemistry	Chin. J. Struct. Chem.
Chinese Physics C	Chin. Phys. C
	Chirality
	Chromatographia
Chromatography Research International	Chromatogr. Res. Int.
Chromosome Research	Chromosome Res.
Circulation Research	Circ. Res.
Clay Minerals	Clay Miner.
Clays and Clay Minerals	Clays Clay Miner.
	Clean: Soil, Air, Water
Clinica Chimica Acta	Clin. Chim. Acta
Clinical Chemistry (Washington, DC, United States)	Clin. Chem. (Washington, DC, U. S.)
Clinical Chemistry and Laboratory Medicine	Clin. Chem. Lab. Med.
Clinical Immunology (Amsterdam, Netherlands)	Clin. Immunol. (Amsterdam, Neth.)
Clinical Proteomics	Clin. Proteomics
Clinical and Experimental Pharmacology and Physiology	Clin. Exp. Pharmacol. Physiol.
Clinical and Vaccine Immunology	Clin. Vaccine Immunol.
	Coatings
Colloid Journal	Colloid J.
Colloid and Polymer Science	Colloid Polym. Sci.
Colloids and Surfaces, A: Physicochemical and Engineering Aspects	Colloids Surf., A
Colloids and Surfaces, B: Biointerfaces	Colloids Surf., B
Coloration Technology	Color. Technol.
Combinatorial Chemistry & High Throughput Screening	Comb. Chem. High Throughput Screening
Combustion Science and Technology	Combust. Sci. Technol.
Combustion and Flame	Combust. Flame
Comments on Inorganic Chemistry	Comments Inorg. Chem.
Communications in Soil Science and Plant Analysis	Commun. Soil Sci. Plant Anal.
Comparative Biochemistry and Physiology, Part A: Molecular & Integrative Physiology	Comp. Biochem. Physiol., Part A: Mol. Integr. Physiol.
Comparative Biochemistry and Physiology, Part B: Biochemistry & Molecular Biology	Comp. Biochem. Physiol., Part B: Biochem. Mol. Biol.
Comparative Biochemistry and Physiology, Part C: Toxicology & Pharmacology	Comp. Biochem. Physiol., Part C: Toxicol. Pharmacol.
Comparative Biochemistry and Physiology, Part D: Genomics & Proteomics	Comp. Biochem. Physiol., Part D: Genomics Proteomics
Comparative Medicine	Comp. Med.
Complex Metals	Complex Met.
Comptes Rendus Chimie	C. R. Chim.
Comptes Rendus Physique	C. R. Phys.
Computational & Theoretical Chemistry	Comput. Theor. Chem.
Computational Biology and Chemistry	Comput. Biol. Chem.
Computer Physics Communications	Comput. Phys. Commun.
Computers & Chemical Engineering	Comput. Chem. Eng.
Contrast Media & Molecular Imaging	Contrast Media Mol. Imaging
	Contrib. Mineral. Petrol.
	Contributions to Mineralogy and Petrology
	Coord. Chem. Rev.
	Coordination Chemistry Reviews
	Corrosion (Houston, TX, U. S.)
	Corrosion (Houston, TX, United States)
	Corros. Eng., Sci. Technol.
	Corrosion Engineering, Science and Technology
	Corros. Rev.
	Corrosion Reviews
	Corros. Sci.
	Corrosion Science
	Crit. Rev. Anal. Chem.
	Critical Reviews in Analytical Chemistry
	Crit. Rev. Solid State Mater. Sci.
	Critical Reviews in Solid State and Materials Sciences
	Croat. Chem. Acta
	Croatica Chemica Acta
	Cryogenics
	CrystEngComm
	Cryst. Growth Des.
	Crystal Growth & Design
	Cryst. Res. Technol.
	Crystal Research and Technology
	Crystallogr. Rep.
	Crystallography Reports
	Crystals
	Cuihua Xuebao
	Curr. Alzheimer Res.
	Current Alzheimer Research
	Curr. Anal. Chem.
	Current Analytical Chemistry
	Curr. Bioact. Compd.
	Current Bioactive Compounds
	Curr. Bioinf.
	Current Bioinformatics
	Curr. Biol.
	Current Biology
	Curr. Cancer Drug Targets
	Current Cancer Drug Targets
	Curr. Catal.
	Current Catalysis
	Curr. Chem. Biol.
	Current Chemical Biology
	Curr. Comput.-Aided Drug Des.
	Current Computer-Aided Drug Design
	Curr. Drug Delivery
	Current Drug Delivery
	Curr. Drug Discovery Technol.
	Current Drug Discovery Technologies
	Curr. Drug Metab.
	Current Drug Metabolism
	Curr. Drug Targets
	Current Drug Targets
	Curr. Enzyme Inhib.
	Current Enzyme Inhibition
	Curr. Gene Ther.
	Current Gene Therapy
	Curr. Genet.
	Current Genetics
	Curr. Genomics
	Current Genomics
	Curr. Green Chem.
	Current Green Chemistry
	Curr. HIV Res.
	Current HIV Research
	Curr. Immunol. Rev.
	Current Immunology Reviews
	Curr. Inorg. Chem.
	Current Inorganic Chemistry
	Curr. Med. Chem.
	Current Medicinal Chemistry
	Curr. Metabolomics
	Current Metabolomics
	Curr. Microbiol.
	Current Microbiology
	Curr. Microwave Chem.
	Current Microwave Chemistry
	Curr. Mol. Med.
	Current Molecular Medicine
	Curr. Mol. Pharmacol.
	Current Molecular Pharmacology
	Curr. Neuropharmacol.
	Current Neuropharmacology
	Curr. Opin. Biotechnol.
	Current Opinion in Biotechnology
	Curr. Opin. Cell Biol.
	Current Opinion in Cell Biology
	Curr. Opin. Chem. Biol.
	Current Opinion in Chemical Biology
	Curr. Opin. Colloid Interface Sci.
	Current Opinion in Colloid & Interface Science
	Curr. Opin. Genet. Dev.
	Current Opinion in Genetics & Development
	Curr. Opin. Immunol.
	Current Opinion in Immunology
	Curr. Opin. Lipidol.
	Current Opinion in Lipidology
	Curr. Opin. Neurobiol.
	Current Opinion in Neurobiology
	Curr. Opin. Pharmacol.
	Current Opinion in Pharmacology
	Curr. Opin. Struct. Biol.
	Current Opinion in Structural Biology
	Curr. Org. Chem.
	Current Organic Chemistry
	Curr. Org. Synth.
	Current Organic Synthesis
	Curr. Organocatal.
	Current Organocatalysis
	Curr. Pharm. Anal.
	Current Pharmaceutical Analysis
	Curr. Pharm. Biotechnol.
	Current Pharmaceutical Biotechnology
	Curr. Pharm. Des.
	Current Pharmaceutical Design
	Curr. Pharmacogenomics Pers. Med.
	Current Pharmacogenomics and Personalized Medicine
	Curr. Protein Pept. Sci.
	Current Protein and Peptide Science
	Curr. Proteomics
	Current Proteomics
	Curr. Radiopharm.
	Current Radiopharmaceuticals
	Curr. Signal Transduction Ther.
	Current Signal Transduction Therapy
	Curr. Stem Cell Res. Ther.
	Current Stem Cell Research & Therapy
	Curr. Top. Med. Chem. (Sharjah, United Arab Emirates)
	Current Topics in Medicinal Chemistry (Sharjah, United Arab Emirates)
	Curr. Vasc. Pharmacol.
	Current Vascular Pharmacology
	Cytokine Growth Factor Rev.
	Cytokine & Growth Factor Reviews
	Cytokine+
	DNA Repair
	DNA Res.
	DNA Research
	DNA Cell Biol.
	DNA and Cell Biology
	Dalton Trans.
	Dalton Transactions
	Dermatol. Clin.
	Dermatologic Clinics
	Dermatol. Surg.
	Dermatologic Surgery
	Desalination
	Des. Monomers Polym.
	Designed Monomers and Polymers
	Development (Cambridge, U. K.)
	Development (Cambridge, United Kingdom)
	Dev. Biol. (Amsterdam, Neth.)
	Developmental Biology (Amsterdam, Netherlands)
	Dev. Cell
	Developmental Cell
	Dev. Neurosci. (Basel, Switz.)
	Developmental Neuroscience (Basel, Switzerland)
	Diabetes
	Diamond Relat. Mater.
	Diamond and Related Materials
	Dianhuaxue
	Differentiation (Oxford, U. K.)
	Differentiation (Oxford, United Kingdom)
	Diqiu Huaxue
	Dokl. Biochem. Biophys.
	Doklady Biochemistry and Biophysics
	Dokl. Chem.
	Doklady Chemistry
	Dokl. Earth Sci.
	Doklady Earth Sciences
	Dokl. Phys. Chem.
	Doklady Physical Chemistry
	Dokl. Phys.
	Doklady Physics
	Dopov. Nats. Akad. Nauk Ukr.
	Dopovidi Natsional'noi Akademii Nauk Ukraini
	Drug Delivery
	Drug Dev. Res.
	Drug Development Research
	Drug Dev. Ind. Pharm.
	Drug Development and Industrial Pharmacy
	Drug Metab. Dispos.
	Drug Metabolism & Disposition
	Drug Metab. Lett.
	Drug Metabolism Letters
	Drug Res. (Stuttgart, Ger.)
	Drug Research (Stuttgart, Germany)
	Drug Test. Anal.
	Drug Testing and Analysis
	Drug Chem. Toxicol. (1977)
	Drug and Chemical Toxicology (1977)
	Dyes Pigm.
	Dyes and Pigments
	ECS J. Solid State Sci. Technol.
	ECS Journal of Solid State Science and Technology
	ECS Trans.
	ECS Transactions
	EMBO J.
	EMBO Journal
	EMBO Mol. Med.
	EMBO Molecular Medicine
	EMBO Rep.
	EMBO Reports
	EPJ Photovoltaics
	EPL
	Earth Planet. Sci. Lett.
	Earth and Planetary Science Letters
	Ecotoxicology
	Ecotoxicol. Environ. Saf.
	Ecotoxicology and Environmental Safety
	Eksp. Klin. Farmakol.
	Eksperimental'naya i Klinicheskaya Farmakologiya
	Electroanalysis
	Electrocatalysis
	Electrochem. Soc. Interface
	Electrochemical Society Interface
	Electrochemistry (Tokyo, Jpn.)
	Electrochemistry (Tokyo, Japan)
	Electrochem. Commun.
	Electrochemistry Communications
	Electrochim. Acta
	Electrochimica Acta
	Electron. Mater. Lett.
	Electronic Materials Letters
	Electrophoresis
	Endocrine
	Endocr., Metab. Immune Disord.: Drug Targets
	Endocrine, Metabolic & Immune Disorders: Drug Targets
	Endocrinology
	Energotekhnol. Resursosberezhenie
	Energotekhnologii i Resursosberezhenie
	Energy Fuels
	Energy & Fuels
	Eng. Life Sci.
	Engineering in Life Sciences
	Environ. Chem.
	Environmental Chemistry
	Environ. Chem. Lett.
	Environmental Chemistry Letters
	Environ. Eng. Sci.
	Environmental Engineering Science
	Environ. Geochem. Health
	Environmental Geochemistry and Health
	Environ. Pollut. (Oxford, U. K.)
	Environmental Pollution (Oxford, United Kingdom)
	Environ. Prog. Sustainable Energy
	Environmental Progress & Sustainable Energy
	Environ. Res.
	Environmental Research
	Environ. Sci. Technol.
	Environmental Science & Technology
	Environ. Sci. Technol. Lett.
	Environmental Science & Technology Letters
	Environ. Sci.: Nano
	Environmental Science: Nano
	Environ. Sci.: Processes Impacts
	Environmental Science: Processes & Impacts
Environmental Technology	Environ. Technol.
Environmental Toxicology	Environ. Toxicol.
Environmental Toxicology and Chemistry	Environ. Toxicol. Chem.
	Environ. Toxicol. Pharmacol.
	Environmental Toxicology and Pharmacology
	Environ. Mol. Mutagen.
	Environmental and Molecular Mutagenesis
	Enzyme Microb. Technol.
	Enzyme and Microbial Technology
	Epigenomics
	Eukaryotic Cell
	Eur. Cytokine Network
	European Cytokine Network
	Eur. Food Res. Technol.
	European Food Research and Technology
	Eur. J. Cell Biol.
	European Journal of Cell Biology
	Eur. J. Chem.
	European Journal of Chemistry
	Eur. J. Drug Metab. Pharmacokinet.
	European Journal of Drug Metabolism and Pharmacokinetics
	Eur. J. Endocrinol.
	European Journal of Endocrinology
	Eur. J. Immunol.
	European Journal of Immunology
	Eur. J. Inorg. Chem.
	European Journal of Inorganic Chemistry
	Eur. J. Lipid Sci. Technol.
	European Journal of Lipid Science and Technology
	Eur. J. Mass Spectrom.
	European Journal of Mass Spectrometry
	Eur. J. Med. Chem.
	European Journal of Medicinal Chemistry
	Eur. J. Mineral.
	European Journal of Mineralogy
	Eur. J. Org. Chem.
	European Journal of Organic Chemistry
	Eur. J. Pharm. Sci.
	European Journal of Pharmaceutical Sciences
	Eur. J. Pharmacol.
	European Journal of Pharmacology
	Eur. Neuropsychopharmacol.
	European Neuropsychopharmacology
	Eur. Phys. J. A
	European Physical Journal A: Hadrons and Nuclei
	Eur. Phys. J. B
	European Physical Journal B: Condensed Matter and Complex
	Systems
	Eur. Phys. J. C
	European Physical Journal C: Particles and Fields
	Eur. Phys. J. D
	European Physical Journal D: Atomic, Molecular, Optical and Plasma Physics
	Eur. Phys. J. E: Soft Matter Biol. Phys.
	European Physical Journal E: Soft Matter and Biological Physics
	Eur. Polym. J.
	European Polymer Journal
	Exp. Mol. Med.
	Experimental & Molecular Medicine
	Exp. Anim.
	Experimental Animals
	Exp. Biol. Med. (London, U. K.)
	Experimental Biology and Medicine (London, United Kingdom)
	Exp. Cell Res.
	Experimental Cell Research
	Exp. Eye Res.
	Experimental Eye Research
	Exp. Clin. Endocrinol. Diabetes
	Experimental and Clinical Endocrinology & Diabetes
	Exp. Mol. Pathol.
	Experimental and Molecular Pathology
	Expert Opin. Invest. Drugs
	Expert Opinion on Investigational Drugs
	Expert Opin. Ther. Pat.
	Expert Opinion on Therapeutic Patents
	Expert Rev. Anti-Infect. Ther.
	Expert Review of Anti-Infective Therapy
	Expert Rev. Anticancer Ther.
	Expert Review of Anticancer Therapy
	Expert Rev. Cardiovasc. Ther.
	Expert Review of Cardiovascular Therapy
	Expert Rev. Clin. Immunol.
	Expert Review of Clinical Immunology
	Expert Rev. Clin. Pharmacol.
	Expert Review of Clinical Pharmacology
	Expert Rev. Endocrinol. Metab.
	Expert Review of Endocrinology & Metabolism
	Expert Rev. Gastroenterol. Hepatol.
	Expert Review of Gastroenterology & Hepatology
	Expert Rev. Hematol.
	Expert Review of Hematology
	Expert Rev. Med. Devices
	Expert Review of Medical Devices
	Expert Rev. Mol. Diagn.
	Expert Review of Molecular Diagnostics
	Expert Rev. Neurother.
	Expert Review of Neurotherapeutics
	Expert Rev. Ophthalmol.
	Expert Review of Ophthalmology
	Expert Rev. Proteomics
	Expert Review of Proteomics
	Expert Rev. Respir. Med.
	Expert Review of Respiratory Medicine
Expert Review of Vaccines	Expert Rev. Vaccines
FASEB Journal	FASEB J.
FEBS Journal	FEBS J.
FEBS Letters	FEBS Lett.
	FEBS Open Bio
Facial Plastic Surgery	Facial Plast. Surg.
Faraday Discussions	Faraday Discuss.
	Fenxi Huaxue
	Fenzi Cuihua
	Ferroelectrics
Ferroelectrics, Letters Section	Ferroelectr., Lett. Sect.
Fibre Chemistry	Fibre Chem.
Fire and Materials	Fire Mater.
Fish Physiology and Biochemistry	Fish Physiol. Biochem.
	Fish. Sci. (Tokyo, Jpn.)
	Fisheries Science (Tokyo, Japan)
	Fiz. Met. Metalloved.
	Fizika Metallov i Metallovedenie
	Fluid Phase Equilib.
	Fluid Phase Equilibria
	Folia Microbiol. (Dordrecht, Neth.)
	Folia Microbiologica (Dordrecht, Netherlands)
	Food Funct.
	Food & Function
	Food Addit. Contam., Part A
	Food Additives & Contaminants, Part A
	Food Addit. Contam., Part B
	Food Additives & Contaminants, Part B: Surveillance
	Food Chem.
	Food Chemistry
	Food Hydrocolloids
	Food Chem. Toxicol.
	Food and Chemical Toxicology
	Free Radical Biol. Med.
	Free Radical Biology & Medicine
	Free Radical Res.
	Free Radical Research
	Fresenius Environ. Bull.
	Fresenius Environmental Bulletin
	Fuel
	Fuel Cells (Weinheim, Ger.)
	Fuel Cells (Weinheim, Germany)
	Fuel Process. Technol.
	Fuel Processing Technology
	Fullerenes, Nanotubes, Carbon Nanostruct.
	Fullerenes, Nanotubes, and Carbon Nanostructures
	Funct. Integr. Genomics
	Functional & Integrative Genomics
	Fundam. Clin. Pharmacol.
	Fundamental & Clinical Pharmacology
	Funtai oyobi Funmatsu Yakin
Fusion Engineering and Design	Fusion Eng. Des.
	Future Cardiol.
	Future Cardiology
	Future Med. Chem.
	Future Medicinal Chemistry
	Future Microbiol.
	Future Microbiology
	Future Neurol.
	Future Neurology
	Future Oncol.
	Future Oncology
	Future Virol.
	Future Virology
	GSTF J. Chem. Sci.
	GSTF Journal of Chemical Sciences
	Gaodeng Xuexiao Huaxue Xuebao
	Gaofenzi Cailiao Kexue Yu Gongcheng
	Gaofenzi Xuebao
	Gaoxiao Huaxue Gongcheng Xuebao
	Gene
	Gene Expression Patterns
Gene Therapy	Gene Ther.
General and Comparative Endocrinology	Gen. Comp. Endocrinol.
	Genes
Genes & Development	Genes Dev.
Genes to Cells	Genes Cells
Genes, Chromosomes & Cancer	Genes, Chromosomes Cancer
	Genome Res.
	Genome Research
	Genomics
	Geochem. J.
	Geochemical Journal
	Geochem. Trans.
	Geochemical Transactions
	Geochem. Int.
	Geochemistry International
	Geochim. Cosmochim. Acta
	Geochimica et Cosmochimica Acta
	Glass Phys. Chem.
	Glass Physics and Chemistry
	Global Biogeochem. Cycles
	Global Biogeochemical Cycles
	Glycobiology
	Glycoconjugate J.
	Glycoconjugate Journal
	Gongneng Gaofenzi Xuebao
	Graphene
	Green Chem.
	Green Chemistry
	Green Chem. Lett. Rev.
	Green Chemistry Letters and Reviews
	Green Process. Synth.
	Green Processing and Synthesis
	Groundwater
	Growth Factors
	Guangpuxue Yu Guangpu Fenxi
	Guijinshu
	Guisuanyan Xuebao
	Guocheng Gongcheng Xuebao
	Health Phys.
	Health Physics
	Heat Transfer Eng.
	Heat Transfer Engineering
	Hecheng Xiangjiao Gongye
	Helv. Chim. Acta
	Helvetica Chimica Acta
	Hemoglobin
	Heteroat. Chem.
	Heteroatom Chemistry
	Heterocycles
	Heterocycl. Commun.
	Heterocyclic Communications
	Heterocycl. Lett.
	Heterocyclic Letters
	High Energy Chem.
	High Energy Chemistry
	High Perform. Polym.
	High Performance Polymers
	High Temp.
	High Temperature
	High Temp. Mater. Processes (Berlin, Ger.)
	High Temperature Materials and Processes (Berlin, Germany)
	Histochem. Cell Biol.
	Histochemistry and Cell Biology
	Holzforschung
	Horm. Mol. Biol. Clin. Invest.
	Hormone Molecular Biology and Clinical Investigation
	Horm. Res. Paediatr.
	Hormone Research in Paediatrics
	Horm. Metab. Res.
	Hormone and Metabolic Research
	Huadong Ligong Daxue Xuebao, Ziran Kexueban
	Huagong Xuebao (Chin. Ed.)
	Huagong Xuebao (Chinese Edition)
	Huanjing Huaxue
	Huanjing Kexue Xuebao
	Huaxue
	Huaxue Fanying Gongcheng Yu Gongyi
	Huaxue Shiji
	Huaxue Tongbao
	Huaxue Xuebao
Human Gene Therapy	Hum. Gene Ther.
	Hum. Gene Ther.: Clin. Dev.
	Human Gene Therapy: Clinical Development
	Hum. Gene Ther: Methods
	Human Gene Therapy: Methods
	Hum. Mol. Genet.
	Human Molecular Genetics
	Hum. Ecol. Risk Assess.
	Human and Ecological Risk Assessment
	Hwahak Konghak
	Hydrometallurgy
	Hyperfine Interact.
	Hyperfine Interactions
	Hypertension
	IEEE J. Quantum Electron.
	IEEE Journal of Quantum Electronics
	IEEE J. Sel. Top. Quantum Electron.
	IEEE Journal of Selected Topics in Quantum Electronics
	IEEE Trans. Nanotechnol.
	IEEE Transactions on Nanotechnology
	ILAR J.
	ILAR Journal
	ISIJ Int.
	ISIJ International
	IUBMB Life
	IUCrJ
	Imaging Med.
	Imaging in Medicine
	Immunity
	Immunobiology
	Immunology
	Immunol. Lett.
	Immunology Letters
	Immunol., Endocr. Metab. Agents Med. Chem.
	Immunology, Endocrine & Metabolic Agents in Medicinal Chemistry
	Immunotherapy
	Indian Chem. Eng.
	Indian Chemical Engineer
	Indian J. Biochem. Biophys.
	Indian Journal of Biochemistry & Biophysics
	Indian J. Chem., Sect. A: Inorg., Bio-inorg., Phys., Theor. Anal. Chem.
	Indian Journal of Chemistry, Section A: Inorganic, Bio-inorganic, Physical, Theoretical & Analytical Chemistry
	Indian J. Chem., Sect. B: Org. Chem. Incl. Med. Chem.
	Indian Journal of Chemistry, Section B: Organic Chemistry Including Medicinal Chemistry
	Indian J. Fibre Text. Res.
	Indian Journal of Fibre & Textile Research
	Indian J. Heterocycl. Chem.
	Indian Journal of Heterocyclic Chemistry
	Indian J. Phys.
	Indian Journal of Physics
	Ind. Eng. Chem. Res.
	Industrial & Engineering Chemistry Research
	Infect. Immun.
	Infection and Immunity
	Infect. Disord.: Drug Targets
	Infectious Disorders: Drug Targets
	Inflammation Allergy: Drug Targets
	Inflammation & Allergy: Drug Targets
	Inflammation Res.
	Inflammation Research
	Inhalation Toxicol.
	Inhalation Toxicology
	Innate Immun.
	Innate Immunity
	Inorg. Chem.
	Inorganic Chemistry
	Inorg. Chem. Commun.
	Inorganic Chemistry Communications
	Inorg. Chem. Front.
	Inorganic Chemistry Frontiers
	Inorg. Mater.
	Inorganic Materials
	Inorg. Chim. Acta
	Inorganica Chimica Acta
	Insect Biochem. Mol. Biol.
	Insect Biochemistry and Molecular Biology
	Insect Mol. Biol.
	Insect Molecular Biology
	Instrum. Sci. Technol.
	Instrumentation Science & Technology
	Intermetallics
	Int. Immunol.
	International Immunology
	Int. Immunopharmacol.
	International Immunopharmacology
	Int. J. Vitam. Nutr. Res.
	International Journal for Vitamin and Nutrition Research
	Int. J. Adhes. Adhes.
	International Journal of Adhesion and Adhesives
	Int. J. Antimicrob. Agents
	International Journal of Antimicrobial Agents
	Int. J. Appl. Ceram. Technol.
	International Journal of Applied Ceramic Technology
	Int. J. Biochem. Cell Biol.
	International Journal of Biochemistry & Cell Biology
	Int. J. Biol. Macromol.
	International Journal of Biological Macromolecules
	Int. J. Biomed. Nanosci. Nanotechnol.
	International Journal of Biomedical Nanoscience and
	Nanotechnology
	Int. J. Cancer
	International Journal of Cancer
	Int. J. Chem. Eng. Appl.
	International Journal of Chemical Engineering and
	Applications
	Int. J. Chem. Kinet.
	International Journal of Chemical Kinetics
	Int. J. Coal Geol.
	International Journal of Coal Geology
	Int. J. Coal Prep. Util.
	International Journal of Coal Preparation and Utilization
	Int. J. Electrochem. Sci.
	International Journal of Electrochemical Science
	Int. J. Electrochem.
	International Journal of Electrochemistry
	Int. J. Environ. Pollut.
	International Journal of Environment and Pollution
	Int. J. Environ. Anal. Chem.
	International Journal of Environmental Analytical Chemistry
	Int. J. Food Sci. Technol.
	International Journal of Food Science and Technology
	Int. J. Genomics
	International Journal of Genomics
	Int. J. Hematol. Oncol.
	International Journal of Hematologic Oncology
	Int. J. Hydrogen Energy
	International Journal of Hydrogen Energy
	Int. J. Immunogenet.
	International Journal of Immunogenetics
	Int. J. Mass Spectrom.
	International Journal of Mass Spectrometry
	Int. J. Mater. Res.
	International Journal of Materials Research
	Int. J. Miner. Process.
	International Journal of Mineral Processing
	Int. J. Mod. Chem.
	International Journal of Modern Chemistry
	Int. J. Mod. Org. Chem.
	International Journal of Modern Organic Chemistry
	Int. J. Multiphase Flow
	International Journal of Multiphase Flow
	Int. J. Nanosci.
	International Journal of Nanoscience
	Int. J. Nonferrous Metall.
	International Journal of Nonferrous Metallurgy
	Int. J. Org. Chem.
	International Journal of Organic Chemistry
	Int. J. PIXE
	International Journal of PIXE
	Int. J. Pept. Res. Ther.
	International Journal of Peptide Research and Therapeutics
	Int. J. Pharm. (Amsterdam, Neth.)
	International Journal of Pharmaceutics (Amsterdam, Netherlands)
	Int. J. Polym. Anal. Charact.
	International Journal of Polymer Analysis and Characterization
	Int. J. Polym. Mater. Polym. Biomater.
	International Journal of Polymeric Materials and Polymeric Biomaterials
	Int. J. Quantum Chem.
	International Journal of Quantum Chemistry
	Int. J. Radiat. Biol.
	International Journal of Radiation Biology
	Int. J. Refract. Met. Hard Mater.
	International Journal of Refractory Metals & Hard Materials
	Int. J. Thermophys.
	International Journal of Thermophysics
	Int. Mater. Rev.
	International Materials Reviews
	Int. Polym. Process.
	International Polymer Processing
	Int. Res. J. Pure Appl. Chem.
	International Research Journal of Pure and Applied Chemistry
	Int. Rev. Phys. Chem.
	International Reviews in Physical Chemistry
	Ionics
	Ironmaking Steelmaking
	Ironmaking & Steelmaking
	Isot. Environ. Health Stud.
	Isotopes in Environmental and Health Studies
	Isr. J. Chem.
	Israel Journal of Chemistry
	Izv. Nats. Akad. Nauk Resp. Kaz., Ser. Khim. Tekhnol.
	Izvestiya Natsional'noi Akademii Nauk Respubliki Kazakhstan, Seriya Khimii i Tekhnologii
	Izv. Vyssh. Uchebn. Zaved., Khim. Khim. Tekhnol.
	Izvestiya Vysshikh Uchebnykh Zavedenii, Khimiya I Khimicheskaya Tekhnologiya
	JAMA, J. Am. Med. Assoc.
	JAMA, the Journal of the American Medical Association
	JBIC, J. Biol. Inorg. Chem.
	JBIC, Journal of Biological Inorganic Chemistry
	JETP Lett.
	JETP Letters
	Jpn. J. Appl. Phys.
	Japanese Journal of Applied Physics
	Jinshu Xuebao
	Jisuanji Yu Yingyong Huaxue
	J. AOAC Int.
	Journal of AOAC International
	J. Adhes.
	Journal of Adhesion
	J. Adhes. Sci. Technol.
	Journal of Adhesion Science and Technology
	J. Adv. Ceram.
	Journal of Advanced Ceramics
	J. Adv. Dielectr.
	Journal of Advanced Dielectrics
	J. Aerosol Sci.
	Journal of Aerosol Science
	J. Agric. Food Chem.
	Journal of Agricultural and Food Chemistry
	J. Alloys Compd.
	Journal of Alloys and Compounds
	J. Anal. At. Spectrom.
	Journal of Analytical Atomic Spectrometry
	J. Anal. Chem.
	Journal of Analytical Chemistry
	J. Anal. Methods Chem.
	Journal of Analytical Methods in Chemistry
	J. Anal. Toxicol.
	Journal of Analytical Toxicology
	J. Anal. Appl. Pyrolysis
	Journal of Analytical and Applied Pyrolysis
	J. Anim. Sci. (Champaign, IL, U. S.)
	Journal of Animal Science (Champaign, IL, United States)
	J. Antibiot.
	Journal of Antibiotics
	J. Antimicrob. Chemother.
	Journal of Antimicrobial Chemotherapy
	J. Appl. Anim. Welfare Sci.
	Journal of Applied Animal Welfare Science
	J. Appl. Crystallogr.
	Journal of Applied Crystallography
	J. Appl. Electrochem.
	Journal of Applied Electrochemistry
	J. Appl. Phys. (Melville, NY, U. S.)
	Journal of Applied Physics (Melville, NY, United States)
	J. Appl. Polym. Sci.
	Journal of Applied Polymer Science
	J. Appl. Solution Chem. Model.
	Journal of Applied Solution Chemistry and Modeling
	J. Appl. Spectrosc.
	Journal of Applied Spectroscopy
	J. Appl. Toxicol.
	Journal of Applied Toxicology
	J. Atmos. Chem.
	Journal of Atmospheric Chemistry
	J. Bacteriol.
	Journal of Bacteriology
	J. Biobased Mater. Bioenergy
	Journal of Biobased Materials and Bioenergy
	J. Biochem. Mol. Toxicol.
	Journal of Biochemical and Molecular Toxicology
	J. Biochem.
	Journal of Biochemistry
	J. Bioenerg. Biomembr.
	Journal of Bioenergetics and Biomembranes
	J. Biol. Chem.
	Journal of Biological Chemistry
	J. Biomater. Sci., Polym. Ed.
	Journal of Biomaterials Science, Polymer Edition
	J. Biomed. Mater. Res., Part A
	Journal of Biomedical Materials Research, Part A
	J. Biomed. Mater. Res., Part B
	Journal of Biomedical Materials Research, Part B: Applied Biomaterials
	J. Biomed. Nanotechnol.
	Journal of Biomedical Nanotechnology
	J. Biomol. NMR
	Journal of Biomolecular NMR
	J. Biomol. Struct. Dyn.
	Journal of Biomolecular Structure and Dynamics
	J. Bionanosci.
	Journal of Bionanoscience
	J. Biorem. Biodegrad.
	Journal of Bioremediation & Biodegradation
	J. Biosci. Bioeng.
	Journal of Bioscience and Bioengineering
	J. Biotechnol.
	Journal of Biotechnology
	J. CO2 Util.
	Journal of CO2 Utilization
	J. Carbohydr. Chem.
	Journal of Carbohydrate Chemistry
	J. Cardiovasc. Pharmacol.
	Journal of Cardiovascular Pharmacology
	J. Catal.
	Journal of Catalysis
	J. Catal.
	Journal of Catalysts
	J. Cell Biol.
	Journal of Cell Biology
	J. Cell Sci.
	Journal of Cell Science
	J. Cell. Biochem.
	Journal of Cellular Biochemistry
	J. Cell. Physiol.
	Journal of Cellular Physiology
	J. Ceram.
	Journal of Ceramics
	J. Chem. Eng. Data
	Journal of Chemical & Engineering Data
	J. Chem. Crystallogr.
	Journal of Chemical Crystallography
	J. Chem. Ecol.
	Journal of Chemical Ecology
	J. Chem. Educ.
	Journal of Chemical Education
	J. Chem. Eng. Jpn.
	Journal of Chemical Engineering of Japan
	J. Chem. Inf. Model.
	Journal of Chemical Information and Modeling
	J. Chem. Phys.
	Journal of Chemical Physics
	J. Chem. Res.
	Journal of Chemical Research
	J. Chem. Sci. (Berlin, Ger.)
	Journal of Chemical Sciences (Berlin, Germany)
	J. Chem. Technol. Biotechnol.
	Journal of Chemical Technology and Biotechnology
	J. Chem. Theory Comput.
	Journal of Chemical Theory and Computation
	J. Chem. Thermodyn.
	Journal of Chemical Thermodynamics
	J. Chemom.
	Journal of Chemometrics
	J. Chromatogr. Sci.
	Journal of Chromatographic Science
	J. Chromatogr. A
	Journal of Chromatography A
	J. Chromatogr. B: Anal. Technol. Biomed. Life Sci.
	Journal of Chromatography B: Analytical Technologies in the Biomedical and Life Sciences
	J. Chromatogr. Sep. Tech.
	Journal of Chromatography and Separation Techniques
	J. Clin. Endocrinol. Metab.
	Journal of Clinical Endocrinology and Metabolism
	J. Cluster Sci.
	Journal of Cluster Science
	J. Coat. Technol. Res.
	Journal of Coatings Technology and Research
	J. Colloid Interface Sci.
	Journal of Colloid and Interface Science
	J. Comput. Biol.
	Journal of Computational Biology
	J. Comput. Chem.
	Journal of Computational Chemistry
	J. Comput. Methods Mol. Des.
	Journal of Computational Methods in Molecular Design
	J. Comput. Theor. Nanosci.
	Journal of Computational and Theoretical Nanoscience
	J. Comput. Chem., Jpn.
	Journal of Computer Chemistry, Japan
	J. Comput.-Aided Mol. Des.
	Journal of Computer-Aided Molecular Design
	J. Contam. Hydrol.
	Journal of Contaminant Hydrology
	J. Controlled Release
	Journal of Controlled Release
	J. Coord. Chem.
	Journal of Coordination Chemistry
	J. Cryst. Growth
	Journal of Crystal Growth
	J. Dairy Res.
	Journal of Dairy Research
	J. Dairy Sci.
	Journal of Dairy Science
	J. Dispersion Sci. Technol.
	Journal of Dispersion Science and Technology
	J. Drug Targeting
	Journal of Drug Targeting
	J. Electroanal. Chem.
	Journal of Electroanalytical Chemistry
	J. Electrochem. Sci. Technol.
	Journal of Electrochemical Science and Technology
	J. Electron Spectrosc. Relat. Phenom.
	Journal of Electron Spectroscopy and Related Phenomena
	J. Electron. Mater.
	Journal of Electronic Materials
	J. Endocrinol.
	Journal of Endocrinology
	J. Energ. Mater.
	Journal of Energetic Materials
	J. Environ. Chem. Eng.
	Journal of Environmental Chemical Engineering
	J. Environ. Eng. (Reston, VA, U.S.)
	Journal of Environmental Engineering (Reston, VA, United States)
	J. Environ. Qual.
	Journal of Environmental Quality
	J. Environ. Radioact.
	Journal of Environmental Radioactivity
	J. Environ. Sci. Eng. (Nagpur, India)
	Journal of Environmental Science & Engineering (Nagpur, India)
	J. Environ. Sci. Health, Part A: Toxic/Hazard. Subst. Environ. Eng.
	Journal of Environmental Science and Health, Part A: Toxic/Hazardous Substances & Environmental Engineering
	J. Environ. Sci. Health, Part B
	Journal of Environmental Science and Health, Part B: Pesticides, Food Contaminants, and Agricultural Wastes
	J. Enzyme Inhib. Med. Chem.
	Journal of Enzyme Inhibition and Medicinal Chemistry
	J. Exp. Bot.
	Journal of Experimental Botany
	J. Exp. Med.
	Journal of Experimental Medicine
	J. Exp. Nanosci.
	Journal of Experimental Nanoscience
	J. Exp. Theor. Phys.
	Journal of Experimental and Theoretical Physics
	J. Fluorine Chem.
	Journal of Fluorine Chemistry
	J. Food Sci.
	Journal of Food Science
	J. Fusion Energy
	Journal of Fusion Energy
	J. Gen. Virol.
	Journal of General Virology
	J. Gen. Appl. Microbiol.
	Journal of General and Applied Microbiology
	J. Geochem. Explor.
	Journal of Geochemical Exploration
	J. Hazard. Mater.
	Journal of Hazardous Materials
	J. Heterocycl. Chem.
	Journal of Heterocyclic Chemistry
	J. Histochem. Cytochem.
	Journal of Histochemistry and Cytochemistry
	J. Hypertens.
	Journal of Hypertension
	J. Imaging Sci. Technol.
	Journal of Imaging Science and Technology
	J. Immunoassay Immunochem.
	Journal of Immunoassay and Immunochemistry
	J. Immunol. Methods
	Journal of Immunological Methods
	J. Immunol.
	Journal of Immunology
	J. Inclusion Phenom. Macrocyclic Chem.
	Journal of Inclusion Phenomena and Macrocyclic Chemistry
	J. Ind. Microbiol. Biotechnol.
	Journal of Industrial Microbiology & Biotechnology
	J. Ind. Eng. Chem. (Amsterdam, Neth.)
	Journal of Industrial and Engineering Chemistry (Amsterdam, Netherlands)
	J. Inorg. Biochem.
	Journal of Inorganic Biochemistry
	J. Inorg. Organomet. Polym. Mater.
	Journal of Inorganic and Organometallic Polymers and Materials
	J. Insect Physiol.
	Journal of Insect Physiology
	J. Interferon Cytokine Res.
	Journal of Interferon & Cytokine Research
	J. Labelled Compd. Radiopharm.
	Journal of Labelled Compounds and Radiopharmaceuticals
	J. Laser Micro/Nanoeng.
	Journal of Laser Micro/Nanoengineering
	J. Leukocyte Biol.
	Journal of Leukocyte Biology
	J. Lipid Res.
	Journal of Lipid Research
	J. Lipid Sci. Technol.
	Journal of Lipid Science and Technology
	J. Liq. Chromatogr. Relat. Technol.
	Journal of Liquid Chromatography & Related Technologies
	J. Low Temp. Phys.
	Journal of Low Temperature Physics
	J. Lumin.
	Journal of Luminescence
	J. Macromol. Sci., Part A: Pure Appl. Chem.
	Journal of Macromolecular Science, Part A: Pure and Applied Chemistry
	J. Macromol. Sci., Part B: Phys.
	Journal of Macromolecular Science, Part B: Physics
	J. Magnesium Alloys
	Journal of Magnesium and Alloys
	J. Magn. Reson.
	Journal of Magnetic Resonance
	J. Magn. Magn. Mater.
	Journal of Magnetism and Magnetic Materials
	J. Mass Spectrom.
	Journal of Mass Spectrometry
	J. Mater. (N. Y., NY, U. S.)
	Journal of Materials (New York, NY, United States)
	J. Mater. Chem. A
	Journal of Materials Chemistry A: Materials for Energy and Sustainability
	J. Mater. Chem. B
	Journal of Materials Chemistry B: Materials for Biology and Medicine
	J. Mater. Chem. C
	Journal of Materials Chemistry C: Materials for Optical and Electronic Devices
	J. Mater. Eng. Perform.
	Journal of Materials Engineering and Performance
	J. Mater. Res.
	Journal of Materials Research
	J. Mater. Sci.
	Journal of Materials Science
	J. Mater. Sci.: Mater. Electron.
	Journal of Materials Science: Materials in Electronics
	J. Mater. Sci.: Mater. Med.
	Journal of Materials Science: Materials in Medicine
	J. Math. Chem.
	Journal of Mathematical Chemistry
	J. Med. Chem.
	Journal of Medicinal Chemistry
	J. Membr. Biol.
	Journal of Membrane Biology
	J. Membr. Sci.
	Journal of Membrane Science
	J. Membr. Sep. Technol.
	Journal of Membrane and Separation Technology
	J. Microencapsulation
	Journal of Microencapsulation
	J. Mol. Biol.
	Journal of Molecular Biology
	J. Mol. Catal. A: Chem.
	Journal of Molecular Catalysis A: Chemical
	J. Mol. Catal. B: Enzym.
	Journal of Molecular Catalysis B: Enzymatic
	J. Mol. Endocrinol.
	Journal of Molecular Endocrinology
	J. Mol. Evol.
	Journal of Molecular Evolution
	J. Mol. Graphics Modell.
	Journal of Molecular Graphics & Modelling
	J. Mol. Liq.
	Journal of Molecular Liquids
	J. Mol. Microbiol. Biotechnol.
	Journal of Molecular Microbiology and Biotechnology
	J. Mol. Neurosci.
	Journal of Molecular Neuroscience
	J. Mol. Recognit.
	Journal of Molecular Recognition
	J. Mol. Spectrosc.
	Journal of Molecular Spectroscopy
	J. Mol. Struct.
	Journal of Molecular Structure
	J. Mol. Cell. Cardiol.
	Journal of Molecular and Cellular Cardiology
	J. Nanoeng. Nanomanuf.
	Journal of Nanoengineering and Nanomanufacturing
	J. Nanopart.
	Journal of Nanoparticles
	J. Nanosci. Nanotechnol.
	Journal of Nanoscience and Nanotechnology
	J. Nat. Prod.
	Journal of Natural Products
	J. Near Infrared Spectrosc.
	Journal of Near Infrared Spectroscopy
	J. Neurochem.
	Journal of Neurochemistry
	J. Neuroendocrinol.
	Journal of Neuroendocrinology
	J. Neuroimmunol.
	Journal of Neuroimmunology
	J. Neurosci.
	Journal of Neuroscience
	J. Neurosci. Res.
	Journal of Neuroscience Research
	J. Non-Cryst. Solids
	Journal of Non-Crystalline Solids
	J. Non-Newtonian Fluid Mech.
	Journal of Non-Newtonian Fluid Mechanics
	J. Nucl. Mater.
	Journal of Nuclear Materials
	J. Nucl. Sci. Technol. (Abingdon, U. K.)
	Journal of Nuclear Science and Technology (Abingdon, United Kingdom)
	J. Nucleic Acids
	Journal of Nucleic Acids
	J. Nutr.
	Journal of Nutrition
	J. Nutr. Biochem.
	Journal of Nutritional Biochemistry
	J. Nutr. Sci. Vitaminol.
	Journal of Nutritional Science and Vitaminology
	J. Ocul. Pharmacol. Ther.
	Journal of Ocular Pharmacology and Therapeutics
	J. Oleo Sci.
	Journal of Oleo Science
	J. Org. Chem.
	Journal of Organic Chemistry
	J. Organomet. Chem.
	Journal of Organometallic Chemistry
	J. Pept. Sci.
	Journal of Peptide Science
	J. Pet. Sci. Eng.
	Journal of Petroleum Science & Engineering
	J. Petrol.
	Journal of Petrology
	J. Pharm. Sci.
	Journal of Pharmaceutical Sciences
	J. Pharm. Biomed. Anal.
	Journal of Pharmaceutical and Biomedical Analysis
	J. Pharmacol. Toxicol. Methods
	Journal of Pharmacological and Toxicological Methods
	J. Pharmacol. Exp. Ther.
	Journal of Pharmacology and Experimental Therapeutics
	J. Pharm. Chem.
	Journal of Pharmacy and Chemistry
	J. Pharm. Pharmacol.
	Journal of Pharmacy and Pharmacology
	J. Phase Equilib. Diffus.
	Journal of Phase Equilibria and Diffusion
	J. Photochem. Photobiol., A
	Journal of Photochemistry and Photobiology, A: Chemistry
	J. Photochem. Photobiol., B
	Journal of Photochemistry and Photobiology, B: Biology
	J. Photochem. Photobiol., C
	Journal of Photochemistry and Photobiology, C: Photochemistry Reviews
	J. Photopolym. Sci. Technol.
	Journal of Photopolymer Science and Technology
	J. Phys. Chem. A
	Journal of Physical Chemistry A
	J. Phys. Chem. B
	Journal of Physical Chemistry B
	J. Phys. Chem. C
	Journal of Physical Chemistry C
	J. Phys. Chem. Lett.
	Journal of Physical Chemistry Letters
	J. Phys. Org. Chem.
	Journal of Physical Organic Chemistry
	J. Phys. Chem. Ref. Data
	Journal of Physical and Chemical Reference Data
	J. Phys. B: At., Mol. Opt. Phys.
	Journal of Physics B: Atomic, Molecular and Optical Physics
	J. Phys. D: Appl. Phys.
	Journal of Physics D: Applied Physics
	J. Phys. G: Nucl. Part. Phys.
	Journal of Physics G: Nuclear and Particle Physics
	J. Phys. Chem. Solids
	Journal of Physics and Chemistry of Solids
	J. Phys.: Condens. Matter
	Journal of Physics: Condensed Matter
	J. Physiol. (Oxford, U. K.)
	Journal of Physiology (Oxford, United Kingdom)
	J. Pineal Res.
	Journal of Pineal Research
	J. Planar Chromatogr.--Mod. TLC
	Journal of Planar Chromatography--Modern TLC
	J. Plant Growth Regul.
	Journal of Plant Growth Regulation
	J. Plant Nutr.
	Journal of Plant Nutrition
	J. Plant Nutr. Soil Sci.
	Journal of Plant Nutrition and Soil Science
	J. Plant Physiol.
	Journal of Plant Physiology
	J. Polym. Mater.
	Journal of Polymer Materials
	J. Polym. Res.
	Journal of Polymer Research
	J. Polym. Sci., Part A: Polym. Chem.
	Journal of Polymer Science, Part A: Polymer Chemistry
	J. Polym. Sci., Part B: Polym. Phys.
	Journal of Polymer Science, Part B: Polymer Physics
	J. Polym. Environ.
	Journal of Polymers and the Environment
	J. Porphyrins Phthalocyanines
	Journal of Porphyrins and Phthalocyanines
	J. Power Sources
	Journal of Power Sources
	J. Process Control
	Journal of Process Control
	J. Proteome Res.
	Journal of Proteome Research
	J. Proteomics
	Journal of Proteomics
	J. Quant. Spectrosc. Radiat. Transfer
	Journal of Quantitative Spectroscopy & Radiative Transfer
	J. Radioanal. Nucl. Chem.
	Journal of Radioanalytical and Nuclear Chemistry
	J. Raman Spectrosc.
	Journal of Raman Spectroscopy
	J. Recept. Signal Transduction
	Journal of Receptors and Signal Transduction
	J. Reinf. Plast. Compos.
	Journal of Reinforced Plastics and Composites
	J. Res. Updates Polym. Sci.
	Journal of Research Updates in Polymer Science
	J. Rheol. (Melville, NY, U. S.)
	Journal of Rheology (Melville, NY, United States)
	J. Sep. Sci.
	Journal of Separation Science
	J. Sol-Gel Sci. Technol.
	Journal of Sol-Gel Science and Technology
	J. Solid State Chem.
	Journal of Solid State Chemistry
	J. Solid State Electrochem.
	Journal of Solid State Electrochemistry
	J. Solution Chem.
	Journal of Solution Chemistry
	J. Spectrosc. (N. Y., NY, U. S.)
	Journal of Spectroscopy (New York, NY, United States)
	J. Steroid Biochem. Mol. Biol.
	Journal of Steroid Biochemistry and Molecular Biology
	J. Struct. Chem.
	Journal of Structural Chemistry
	J. Struct. Funct. Genomics
	Journal of Structural and Functional Genomics
	J. Sulfur Chem.
	Journal of Sulfur Chemistry
	J. Supercond. Novel Magn.
	Journal of Superconductivity and Novel Magnetism
	J. Supercrit. Fluids
	Journal of Supercritical Fluids
	J. Surf. Invest.: X-Ray, Synchrotron Neutron Tech.
	Journal of Surface Investigation: X-Ray, Synchrotron and Neutron Techniques
	J. Surfactants Deterg.
	Journal of Surfactants and Detergents
	J. Sustainable Cem.-Based Mater.
	Journal of Sustainable Cement-Based Materials
	J. Theor. Comput. Chem.
	Journal of Theoretical and Computational Chemistry
	J. Therm. Anal. Calorim.
	Journal of Thermal Analysis and Calorimetry
	J. Thermodyn. Catal.
	Journal of Thermodynamics & Catalysis
	J. Thermophys. Heat Transfer
	Journal of Thermophysics and Heat Transfer
	J. Toxicol. Environ. Health, Part A
	Journal of Toxicology and Environmental Health, Part A: Current Issues
	J. Toxicol. Environ. Health, Part B
	Journal of Toxicology and Environmental Health, Part B: Critical Reviews
	J. Vac. Sci. Technol., A
	Journal of Vacuum Science & Technology, A: Vacuum, Surfaces, and Films
	J. Vac. Sci. Technol., B: Nanotechnol. Microelectron.: Mater., Process., Meas., Phenom.
	Journal of Vacuum Science & Technology, B: Nanotechnology & Microelectronics: Materials, Processing, Measurement, & Phenomena
	J. Vinyl Addit. Technol.
	Journal of Vinyl and Additive Technology
	J. Virol. Methods
	Journal of Virological Methods
	J. Virol.
	Journal of Virology
	J. Volcanol. Geotherm. Res.
	Journal of Volcanology and Geothermal Research
	J. Wood Chem. Technol.
	Journal of Wood Chemistry and Technology
	J. Am. Ceram. Soc.
	Journal of the American Ceramic Society
	J. Am. Chem. Soc.
	Journal of the American Chemical Society
	J. Am. Oil Chem. Soc.
	Journal of the American Oil Chemists' Society
	J. Am. Soc. Mass Spectrom.
	Journal of the American Society for Mass Spectrometry
	J. Am. Soc. Brew. Chem.
	Journal of the American Society of Brewing Chemists
	J. Am. Stat. Assoc.
	Journal of the American Statistical Association
	J. Braz. Chem. Soc.
	Journal of the Brazilian Chemical Society
	J. Ceram. Soc. Jpn.
	Journal of the Ceramic Society of Japan
	J. Chem. Soc. Pak.
	Journal of the Chemical Society of Pakistan
	J. Chil. Chem. Soc.
	Journal of the Chilean Chemical Society
	J. Chin. Adv. Mater. Soc.
	Journal of the Chinese Advanced Materials Society
	J. Chin. Chem. Soc. (Weinheim, Ger.)
	Journal of the Chinese Chemical Society (Weinheim, Germany)
	J. Electrochem. Soc.
	Journal of the Electrochemical Society
	J. Energy Inst.
	Journal of the Energy Institute
	J. Eur. Ceram. Soc.
	Journal of the European Ceramic Society
	J. Indian Chem. Soc.
	Journal of the Indian Chemical Society
	J. Inst. Chem. (India)
	Journal of the Institution of Chemists (India)
	J. Jpn. Pet. Inst.
	Journal of the Japan Petroleum Institute
	J. Korean Ceram. Soc.
	Journal of the Korean Ceramic Society
	J. Korean Chem. Soc.
	Journal of the Korean Chemical Society
	J. Opt. Soc. Am. B
	Journal of the Optical Society of America B: Optical Physics
	J. Sci. Food Agric.
	Journal of the Science of Food and Agriculture
	J. Serb. Chem. Soc.
	Journal of the Serbian Chemical Society
	J. Soc. Inorg. Mater., Jpn.
	Journal of the Society of Inorganic Materials, Japan
	J. Taiwan Inst. Chem. Eng.
	Journal of the Taiwan Institute of Chemical Engineers
	KGK, Kautsch. Gummi Kunstst.
	KGK, Kautschuk Gummi Kunststoffe
	Kagaku Kogaku Ronbunshu
	Kem. Ind.
	Kemija u Industriji
	Khim. Prom-st. Segodnya
	Khimicheskaya Promyshlennost Segodnya
	Khim. Tekhnol. Vody
	Khimiya i Tekhnologiya Vody
	Khim. Interesakh Ustoich. Razvit.
	Khimiya v Interesakh Ustoichivogo Razvitiya
	Kinet. Catal.
	Kinetics and Catalysis
	Kobunshi Ronbunshu
	Korean J. Chem. Eng.
	Korean Journal of Chemical Engineering
	LCGC North Am.
	LCGC North America
	LWT--Food Sci. Technol.
	LWT--Food Science and Technology
	Lab Chip
	Lab on a Chip
	Lab. Anim.
	Laboratory Animals
	Langmuir
	Laser Part. Beams
	Laser and Particle Beams
	Latv. Kim. Z.
	Latvijas Kimijas Zurnals
	Lett. Drug Des. Discovery
	Letters in Drug Design & Discovery
	Lett. Org. Chem.
	Letters in Organic Chemistry
	Life Sci.
	Life Sciences
	Light: Sci. Appl.
	Light: Science & Applications
	Linchan Huaxue Yu Gongye
	Lipids
	Liq. Cryst.
	Liquid Crystals
	Liq. Cryst. Rev.
	Liquid Crystals Reviews
	Lithos
	Lung Cancer Manage.
	Lung Cancer Management
	MRS Commun.
	MRS Communications
	MRS Online Proc. Libr.
	MRS Online Proceedings Library
	Macromol. Biosci.
	Macromolecular Bioscience
	Macromol. Chem. Phys.
	Macromolecular Chemistry and Physics
	Macromol. Mater. Eng.
	Macromolecular Materials and Engineering
	Macromol. Rapid Commun.
	Macromolecular Rapid Communications
	Macromol. React. Eng.
	Macromolecular Reaction Engineering
	Macromol. Res.
	Macromolecular Research
	Macromol. Symp.
	Macromolecular Symposia
	Macromol. Theory Simul.
	Macromolecular Theory and Simulations
	Macromolecules (Washington, DC, U. S.)
	Macromolecules (Washington, DC, United States)
	Magnesium Res.
	Magnesium Research
	Magn. Reson. Chem.
	Magnetic Resonance in Chemistry
	Main Group Chem.
	Main Group Chemistry
	Main Group Met. Chem.
	Main Group Metal Chemistry
	Mar. Biotechnol.
	Marine Biotechnology
	Mar. Chem.
	Marine Chemistry
	Mar. Environ. Res.
	Marine Environmental Research
	Mar. Pollut. Bull.
	Marine Pollution Bulletin
	Mater. Charact.
	Materials Characterization
	Mater. Chem. Phys.
	Materials Chemistry and Physics
	Mater. Express
	Materials Express
	Mater. Focus
	Materials Focus
	Mater. Horiz.
	Materials Horizons
	Mater. Lett.
	Materials Letters
	Mater. Perform. Charact.
	Materials Performance and Characterization
	Mater. Res. Bull.
	Materials Research Bulletin
	Mater. Res. Express
	Materials Research Express
	Mater. Res. Innovations
	Materials Research Innovations
	Mater. Res. Lett.
	Materials Research Letters
	Mater. Sci. Eng., A
	Materials Science & Engineering, A: Structural Materials: Properties, Microstructure and Processing
	Mater. Sci. Eng., B
	Materials Science & Engineering, B: Advanced Functional Solid-State Materials
	Mater. Sci. Eng., C
	Materials Science & Engineering, C: Materials for Biological Applications
	Mater. Sci. Technol.
	Materials Science and Technology
	Mater. Sci. Semicond. Process.
	Materials Science in Semiconductor Processing
	Mater. Trans.
	Materials Transactions
	Mater. Corros.
	Materials and Corrosion
	Mater. Manuf. Processes
	Materials and Manufacturing Processes
	Matrix Biol.
	Matrix Biology
	Meas. Sci. Technol.
	Measurement Science and Technology
	Mech. Dev.
	Mechanisms of Development
	MedChemComm
	Med. Chem. (Sharjah, United Arab Emirates)
	Medicinal Chemistry (Sharjah, United Arab Emirates)
	Med. Chem. Res.
	Medicinal Chemistry Research
	Membranes (Basel, Switz.)
	Membranes (Basel, Switzerland)
	Mendeleev Commun.
	Mendeleev Communications
	Metab. Eng.
	Metabolic Engineering
	Metab., Clin. Exp.
	Metabolism, Clinical and Experimental
	Metabolites
	Metabolomics
	Met. Sci. Heat Treat.
	Metal Science and Heat Treatment
	Metallofiz. Noveishie Tekhnol.
	Metallofizika i Noveishie Tekhnologii
	Metall. Mater. Trans. A
	Metallurgical and Materials Transactions A: Physical Metallurgy and Materials Science
	Metall. Mater. Trans. B
	Metallurgical and Materials Transactions B: Process Metallurgy and Materials Processing Science
	Metals (Basel, Switz.)
	Metals (Basel, Switzerland)
	Meteorit. Planet. Sci.
	Meteoritics & Planetary Science
	Methods (Amsterdam, Neth.)
	Methods (Amsterdam, Netherlands)
	Microbiology (London, U. K.)
	Microbiology (London, United Kingdom)
	Microbiology (Moscow, Russ. Fed.)
	Microbiology (Moscow, Russian Federation)
	Microbiol. Immunol.
	Microbiology and Immunology
	Microchem. J.
	Microchemical Journal
	Microchim. Acta
	Microchimica Acta
	Microelectron. Eng.
	Microelectronic Engineering
	Microporous Mesoporous Mater.
	Microporous and Mesoporous Materials
	Microsc. Microanal.
	Microscopy and Microanalysis
	Miner. Deposita
	Mineralium Deposita
	Mineral. Petrol.
	Mineralogy and Petrology
	Miner. Eng.
	Minerals Engineering
	Mini-Rev. Med. Chem.
	Mini-Reviews in Medicinal Chemistry
	Mini-Rev. Org. Chem.
	Mini-Reviews in Organic Chemistry
	Mitochondrial DNA
	Mitochondrion
	Mod. Phys. Lett. B
	Modern Physics Letters B
	Mod. Res. Catal.
	Modern Research in Catalysis
	Mol. Biochem. Parasitol.
	Molecular & Biochemical Parasitology
	Mol. Cell. Proteomics
	Molecular & Cellular Proteomics
	Mol. Cell. Toxicol.
	Molecular & Cellular Toxicology
	Mol. BioSyst.
	Molecular BioSystems
	Mol. Biol. (Moscow, Russ. Fed., Engl. Ed.)
	Molecular Biology (Moscow, Russian Federation, English Edition)
	Mol. Biol. Rep.
	Molecular Biology Reports
	Mol. Biol. Evol.
	Molecular Biology and Evolution
	Mol. Biol. Cell
	Molecular Biology of the Cell
	Mol. Biotechnol.
	Molecular Biotechnology
	Mol. Cancer Res.
	Molecular Cancer Research
	Mol. Cancer Ther.
	Molecular Cancer Therapeutics
	Mol. Carcinog.
	Molecular Carcinogenesis
	Mol. Cell
	Molecular Cell
	Mol. Cryst. Liq. Cryst.
	Molecular Crystals and Liquid Crystals
	Mol. Diversity
	Molecular Diversity
	Mol. Endocrinol.
	Molecular Endocrinology
	Mol. Genet. Genomics
	Molecular Genetics and Genomics
	Mol. Genet. Metab.
	Molecular Genetics and Metabolism
	Mol. Immunol.
	Molecular Immunology
	Mol. Inf.
	Molecular Informatics
Molecular Medicine (Manhasset, NY, United States)	Mol. Med. (Manhasset, NY, U. S.)
Molecular Medicine Reports	Mol. Med. Rep.
Molecular Membrane Biology	Mol. Membr. Biol.
Molecular Metabolism	Mol. Metab.
Molecular Microbiology	Mol. Microbiol.
Molecular Neurobiology	Mol. Neurobiol.
	 
Molecular Nutrition & Food Research	Mol. Nutr. Food Res.
Molecular Pharmaceutics	Mol. Pharmaceutics
Molecular Pharmacology	Mol. Pharmacol.
Molecular Physics	Mol. Phys.
Molecular Plant	Mol. Plant
Molecular Plant-Microbe Interactions	Mol. Plant-Microbe Interact.
Molecular Reproduction & Development	Mol. Reprod. Dev.
Molecular Simulation	Mol. Simul.
Molecular Therapy	Mol. Ther.
Molecular Therapy--Methods & Clinical Development	Mol. Ther.--Methods Clin. Dev.
Molecular Therapy--Nucleic Acids	Mol. Ther.--Nucleic Acids
Molecular and Cellular Biochemistry	Mol. Cell. Biochem.
Molecular and Cellular Biology	Mol. Cell. Biol.
Molecular and Cellular Endocrinology	Mol. Cell. Endocrinol.
Molecular and Cellular Neuroscience	Mol. Cell. Neurosci.
Molecular and Cellular Probes	Mol. Cell. Probes
	Molecules
Molecules and Cells	Mol. Cells
Monatshefte fuer Chemie	Monatsh. Chem.
Mucosal Immunology	Mucosal Immunol.
	Mutagenesis
Mutation Research, Fundamental and Molecular Mechanisms of Mutagenesis	Mutat. Res., Fundam. Mol. Mech. Mutagen.
Mutation Research, Genetic Toxicology and Environmental Mutagenesis	Mutat. Res., Genet. Toxicol. Environ. Mutagen.
Mutation Research, Reviews in Mutation Research	Mutat. Res., Rev. Mutat. Res.
	Nano
	Nano Energy
Nano Letters	Nano Lett.
Nano Science and Nano Technology: An Indian Journal	Nano Sci. Nano Technol.: Indian J.
	Nanomaterials
Nanomedicine (London, United Kingdom)	Nanomedicine (London, U. K.)
Nanomedicine (New York, NY, United States)	Nanomedicine (N. Y., NY, U. S.)
	Nanoscale
Natural Product Reports	Nat. Prod. Rep.
Natural Product Research	Nat. Prod. Res.
Natural Product Sciences	Nat. Prod. Sci.
Natural Products Journal	Nat. Prod. J.
Nature (London, United Kingdom)	Nature (London, U. K.)
Nature Biotechnology	Nat. Biotechnol.
Nature Cell Biology	Nat. Cell Biol.
Nature Chemical Biology	Nat. Chem. Biol.
Nature Chemistry	Nat. Chem.
Nature Communications	Nat. Commun.
Nature Genetics	Nat. Genet.
Nature Geoscience	Nat. Geosci.
Nature Immunology	Nat. Immunol.
Nature Materials	Nat. Mater.
Nature Medicine (New York, NY, United States)	Nat. Med. (N. Y., NY, U. S.)
Nature Methods	Nat. Methods
Nature Nanotechnology	Nat. Nanotechnol.
Nature Neuroscience	Nat. Neurosci.
Nature Photonics	Nat. Photonics
Nature Physics	Nat. Phys.
Nature Protocols	Nat. Protoc.
Nature Reviews Cancer	Nat. Rev. Cancer
Nature Reviews Drug Discovery	Nat. Rev. Drug Discovery
Nature Reviews Genetics	Nat. Rev. Genet.
Nature Reviews Immunology	Nat. Rev. Immunol.
Nature Reviews Microbiology	Nat. Rev. Microbiol.
Nature Reviews Molecular Cell Biology	Nat. Rev. Mol. Cell Biol.
Nature Reviews Neuroscience	Nat. Rev. Neurosci.
Nature Structural & Molecular Biology	Nat. Struct. Mol. Biol.
	Naturwissenschaften
Naunyn-Schmiedeberg's Archives of Pharmacology	Naunyn-Schmiedeberg's Arch. Pharmacol.
Neues Jahrbuch fuer Mineralogie, Abhandlungen	Neues Jahrb. Mineral., Abh.
	NeuroImmunoModulation
NeuroMolecular Medicine	NeuroMol. Med.
Neurochemical Research	Neurochem. Res.
Neurochemistry International	Neurochem. Int.
	Neuroendocrinology
	Neuron
Neuropeptides (Oxford, United Kingdom)	Neuropeptides (Oxford, U. K.)
	Neuropharmacology
Neuroscience (Amsterdam, Netherlands)	Neuroscience (Amsterdam, Neth.)
Neuroscience Letters	Neurosci. Lett.
Neurotoxicology and Teratology	Neurotoxicol. Teratol.
New Biotechnology	New Biotechnol.
New England Journal of Medicine	N. Engl. J. Med.
New Journal of Chemistry	New J. Chem.
	Nihon Reoroji Gakkaishi
	Nippon Kinzoku Gakkaishi
	Nitric Oxide
Nordic Pulp & Paper Research Journal	Nord. Pulp Pap. Res. J.
Nuclear Engineering and Design	Nucl. Eng. Des.
Nuclear Fusion	Nucl. Fusion
Nuclear Instruments & Methods in Physics Research, Section A: Accelerators, Spectrometers, Detectors, and Associated Equipment	Nucl. Instrum. Methods Phys. Res., Sect. A
Nuclear Instruments & Methods in Physics Research, Section B: Beam Interactions with Materials and Atoms	Nucl. Instrum. Methods Phys. Res., Sect. B
Nuclear Medicine and Biology	Nucl. Med. Biol.
Nuclear Physics A	Nucl. Phys. A
Nuclear Physics B	Nucl. Phys. B
Nucleic Acid Therapeutics	Nucleic Acid Ther.
Nucleic Acids Research	Nucleic Acids Res.
Nucleosides, Nucleotides & Nucleic Acids	Nucleosides, Nucleotides Nucleic Acids
	Nukleonika
Nutrition Research (New York, NY, United States)	Nutr. Res. (N. Y., NY, U. S.)
	OMICS
	Oncogene
Open Journal of Inorganic Non-Metallic Materials	Open J. Inorg. Non-Met. Mater.
Open Journal of Medicinal Chemistry	Open J. Med. Chem.
Open Journal of Organic Polymer Materials	Open J. Org. Polym. Mater.
Open Journal of Polymer Chemistry	Open J. Polym. Chem.
Open Journal of Synthesis Theory and Applications	Open J. Synth. Theory Appl.
Optics Communications	Opt. Commun.
Optics and Spectroscopy	Opt. Spectrosc.
Organic & Biomolecular Chemistry	Org. Biomol. Chem.
Organic Chemistry Frontiers	Org. Chem. Front.
Organic Chemistry International	Org. Chem. Int.
Organic Electronics	Org. Electron.
Organic Geochemistry	Org. Geochem.
Organic Letters	Org. Lett.
Organic Preparations and Procedures International	Org. Prep. Proced. Int.
Organic Process Research & Development	Org. Process Res. Dev.
Organic Syntheses	Org. Synth.
Organic and Medicinal Chemistry Letters	Org. Med. Chem. Lett.
	Organometallics
Oriental Journal of Chemistry	Orient. J. Chem.
Oxidation Communications	Oxid. Commun.
Oxidation of Metals	Oxid. Met.
Ozone: Science & Engineering	Ozone: Sci. Eng.
PLoS Biology	PLoS Biol.
PLoS Computational Biology	PLoS Comput. Biol.
PLoS Genetics	PLoS Genet.
	PLoS One
PLoS Pathogens	PLoS Pathog.
PMSE Preprints	PMSE Prepr.
Particulate Science and Technology	Part. Sci. Technol.
Peptides (New York, NY, United States)	Peptides (N. Y., NY, U. S.)
Personalized Medicine	Pers. Med.
Pest Management Science	Pest Manage. Sci.
Pesticide Biochemistry and Physiology	Pestic. Biochem. Physiol.
Petroleum Chemistry	Pet. Chem.
Petroleum Science and Technology	Pet. Sci. Technol.
Pfluegers Archiv	Pfluegers Arch.
Pharma Chemica	Pharma Chem.
Pharmaceutical Chemistry Journal	Pharm. Chem. J.
Pharmaceutical Development and Technology	Pharm. Dev. Technol.
Pharmaceutical Nanotechnology	Pharm. Nanotechnol.
Pharmaceutical Patent Analyst	Pharm. Pat. Anal.
Pharmaceutical Research	Pharm. Res.
Pharmacia Sinica	Pharm. Sin.
Pharmacogenetics and Genomics	Pharmacogenet. Genomics
	Pharmacogenomics
Pharmacogenomics Journal	Pharmacogenomics J.
	Pharmacology
Pharmacology & Therapeutics	Pharmacol. Ther.
Pharmacology, Biochemistry and Behavior	Pharmacol., Biochem. Behav.
	Pharmazie
	Phase Transitions
Philosophical Magazine	Philos. Mag.
Philosophical Magazine Letters	Philos. Mag. Lett.
Phosphorus, Sulfur and Silicon and the Related Elements	Phosphorus, Sulfur Silicon Relat. Elem.
Photochemical & Photobiological Sciences	Photochem. Photobiol. Sci.
Photochemistry and Photobiology	Photochem. Photobiol.
Photosynthesis Research	Photosynth. Res.
Physica B: Condensed Matter (Amsterdam, Netherlands)	Phys. B (Amsterdam, Neth.)
Physica C: Superconductivity and Its Applications (Amsterdam, Netherlands)	Phys. C (Amsterdam, Neth.)
Physica Scripta	Phys. Scr.
Physica Scripta, T	Phys. Scr., T
Physica Status Solidi A: Applications and Materials Science	Phys. Status Solidi A
Physica Status Solidi B: Basic Solid State Physics	Phys. Status Solidi B
Physica Status Solidi C: Current Topics in Solid State Physics	Phys. Status Solidi C
Physica Status Solidi RRL: Rapid Research Letters	Phys. Status Solidi RRL
Physical Chemistry Chemical Physics	Phys. Chem. Chem. Phys.
Physical Review A: Atomic, Molecular, and Optical Physics	Phys. Rev. A: At., Mol., Opt. Phys.
Physical Review Applied	Phys. Rev. Appl.
Physical Review B: Condensed Matter and Materials Physics	Phys. Rev. B: Condens. Matter Mater. Phys.
Physical Review C: Nuclear Physics	Phys. Rev. C: Nucl. Phys.
Physical Review D: Particles, Fields, Gravitation, and Cosmology	Phys. Rev. D: Part., Fields, Gravitation, Cosmol.
Physical Review E: Statistical, Nonlinear, and Soft Matter Physics	Phys. Rev. E: Stat., Nonlinear, Soft Matter Phys.
Physical Review Letters	Phys. Rev. Lett.
Physical Review X	Phys. Rev. X
Physics Letters A	Phys. Lett. A
Physics Letters B	Phys. Lett. B
Physics and Chemistry of Liquids	Phys. Chem. Liq.
Physics and Chemistry of Minerals	Phys. Chem. Miner.
Physics of Atomic Nuclei	Phys. At. Nucl.
Physics of Fluids	Phys. Fluids
Physics of Plasmas	Phys. Plasmas
Physics of the Solid State	Phys. Solid State
Physiologia Plantarum	Physiol. Plant.
Physiology & Behavior	Physiol. Behav.
Phytochemical Analysis	Phytochem. Anal.
	Phytochemistry (Elsevier)
Phytochemistry Reviews	Phytochem. Rev.
	Plant Cell
Plant Cell Reports	Plant Cell Rep.
Plant Growth Regulation	Plant Growth Regul.
Plant Journal	Plant J.
Plant Molecular Biology	Plant Mol. Biol.
Plant Physiology	Plant Physiol.
Plant Physiology and Biochemistry (Issy-les-Moulineaux, France)	Plant Physiol. Biochem. (Issy-les-Moulineaux, Fr.)
Plant Science (Shannon, Ireland)	Plant Sci. (Shannon, Irel.)
Plant and Cell Physiology	Plant Cell Physiol.
Plant and Soil	Plant Soil
	Planta
Planta Medica	Planta Med.
Plasma Chemistry and Plasma Processing	Plasma Chem. Plasma Process.
Plasma Processes and Polymers	Plasma Processes Polym.
	Plasmid
Plastic and Reconstructive Surgery	Plast. Reconstr. Surg.
Plasticheskie Massy	Plast. Massy
Plastics, Rubber and Composites	Plast., Rubber Compos.
	Platelets
Polish Journal of Chemical Technology	Pol. J. Chem. Technol.
Polycyclic Aromatic Compounds	Polycyclic Aromat. Compd.
	Polyhedron
	Polymer
	Polymer (Korea)
Polymer Bulletin (Heidelberg, Germany)	Polym. Bull. (Heidelberg, Ger.)
Polymer Chemistry	Polym. Chem.
Polymer Composites	Polym. Compos.
Polymer Degradation and Stability	Polym. Degrad. Stab.
Polymer Engineering & Science	Polym. Eng. Sci.
Polymer International	Polym. Int.
Polymer Journal (Tokyo, Japan)	Polym. J. (Tokyo, Jpn.)
Polymer Preprints (American Chemical Society, Division of Polymer Chemistry)	Polym. Prepr. (Am. Chem. Soc., Div. Polym. Chem.)
Polymer Reviews (Philadelphia, PA, United States)	Polym. Rev. (Philadelphia, PA, U. S.)
Polymer Science, Series A	Polym. Sci., Ser. A
Polymer Science, Series B	Polym. Sci., Ser. B
Polymer Science, Series C	Polym. Sci., Ser. C
Polymer Science, Series D	Polym. Sci., Ser. D
Polymer Testing	Polym. Test.
Polymer-Plastics Technology and Engineering	Polym.-Plast. Technol. Eng.
Polymers & Polymer Composites	Polym. Polym. Compos.
Polymers (Basel, Switzerland)	Polymers (Basel, Switz.)
Polymers for Advanced Technologies	Polym. Adv. Technol.
Powder Diffraction	Powder Diffr.
Powder Metallurgy	Powder Metall.
Powder Metallurgy and Metal Ceramics	Powder Metall. Met. Ceram.
Powder Technology	Powder Technol.
Practical Spectroscopy	Pract. Spectrosc.
Precambrian Research	Precambrian Res.
Preparative Biochemistry & Biotechnology	Prep. Biochem. Biotechnol.
Preprints - American Chemical Society, Division of Energy & Fuels	Prepr. - Am. Chem. Soc., Div. Energy Fuels
Procedia Materials Science	Procedia Mater. Sci.
Proceedings of the National Academy of Sciences of the United States of America	Proc. Natl. Acad. Sci. U. S. A.
Process Biochemistry (Oxford, United Kingdom)	Process Biochem. (Oxford, U. K.)
Process Safety and Environmental Protection	Process Saf. Environ. Prot.
Progress in Colloid and Polymer Science	Prog. Colloid Polym. Sci.
Progress in Crystal Growth and Characterization of Materials	Prog. Cryst. Growth Charact. Mater.
Progress in Inorganic Chemistry	Prog. Inorg. Chem.
Progress in Nuclear Magnetic Resonance Spectroscopy	Prog. Nucl. Magn. Reson. Spectrosc.
Progress in Organic Coatings	Prog. Org. Coat.
Progress in Polymer Science	Prog. Polym. Sci.
Progress in Reaction Kinetics and Mechanism	Prog. React. Kinet. Mech.
Progress in Solid State Chemistry	Prog. Solid State Chem.
Progress in Surface Science	Prog. Surf. Sci.
Propellants, Explosives, Pyrotechnics	Propellants, Explos., Pyrotech.
Prostaglandins and Other Lipid Mediators	Prostaglandins Other Lipid Mediators
Prostaglandins, Leukotrienes and Essential Fatty Acids	Prostaglandins, Leukotrienes Essent. Fatty Acids
Protection of Metals and Physical Chemistry of Surfaces	Prot. Met. Phys. Chem. Surf.
Protein & Peptide Letters	Protein Pept. Lett.
Protein Engineering, Design & Selection	Protein Eng., Des. Sel.
Protein Expression and Purification	Protein Expression Purif.
Protein Journal	Protein J.
Protein Science	Protein Sci.
Proteins: Structure, Function, and Bioinformatics	Proteins: Struct., Funct., Bioinf.
	Proteomics
Proteomics: Clinical Applications	Proteomics: Clin. Appl.
Przemysl Chemiczny	Przem. Chem.
Psychopharmacology (Heidelberg, Germany)	Psychopharmacology (Heidelberg, Ger.)
	Pteridines
Pulmonary Pharmacology & Therapeutics	Pulm. Pharmacol. Ther.
Pure and Applied Chemistry	Pure Appl. Chem.
	Purinergic Signalling
Quantum Electronics	Quantum Electron.
Quimica Nova	Quim. Nova
	RNA
RSC Advances	RSC Adv.
Radiation Effects and Defects in Solids	Radiat. Eff. Defects Solids
Radiation Measurements	Radiat. Meas.
Radiation Physics and Chemistry	Radiat. Phys. Chem.
Radiation Research	Radiat. Res.
Radiochemistry (Moscow, Russian Federation)	Radiochemistry (Moscow, Russ. Fed.)
Radiochimica Acta	Radiochim. Acta
	Radioprotection
	Ranliao Huaxue Xuebao
Rapid Communications in Mass Spectrometry	Rapid Commun. Mass Spectrom.
Rare Metals (Beijing, China)	Rare Met. (Beijing, China)
Reaction Kinetics, Mechanisms and Catalysis	React. Kinet., Mech. Catal.
Reactive & Functional Polymers	React. Funct. Polym.
Recent Advances in Cardiovascular Drug Discovery	Recent Adv. Cardiovasc. Drug Discovery
Recent Advances in DNA & Gene Sequences	Recent Adv. DNA Gene Sequences
Recent Patents on Anti-Cancer Drug Discovery	Recent Pat. Anti-Cancer Drug Discovery
Recent Patents on Anti-Infective Drug Discovery	Recent Pat. Anti-Infect. Drug Discovery
	Recent Pat. Biotechnol.
Recent Patents on CNS Drug Discovery	Recent Pat. CNS Drug Discovery
Recent Patents on Drug Delivery & Formulation	Recent Pat. Drug Delivery Formulation
Recent Patents on Endocrine, Metabolic & Immune Drug Discovery	Recent Pat. Endocr., Metab. Immune Drug Discovery
Recent Patents on Inflammation & Allergy Drug Discovery	Recent Pat. Inflammation Allergy Drug Discovery
Recent Patents on Nanotechnology	Recent Pat. Nanotechnol.
Redox Biology	Redox Biol.
Regenerative Medicine	Regener. Med.
	Rengong Jingti Xuebao
Reproduction (Bristol, United Kingdom)	Reproduction (Bristol, U. K.)
Reproductive Toxicology	Reprod. Toxicol.
Research on Chemical Intermediates	Res. Chem. Intermed.
Review of Scientific Instruments	Rev. Sci. Instrum.
Reviews in Analytical Chemistry	Rev. Anal. Chem.
Reviews in Inorganic Chemistry	Rev. Inorg. Chem.
Revista Mexicana de Ingenieria Quimica	Rev. Mex. Ing. Quim.
Revista Peruana de Quimica e Ingenieria Quimica	Rev. Peru. Quim. Ing. Quim.
Revista Romana de Materiale	Rev. Rom. Mater.
Revista de Chimie (Bucharest, Romania)	Rev. Chim. (Bucharest, Rom.)
Revista de la Sociedad Quimica del Peru	Rev. Soc. Quim. Peru
Rheologica Acta	Rheol. Acta
Rubber Chemistry and Technology	Rubber Chem. Technol.
Russian Chemical Bulletin	Russ. Chem. Bull.
Russian Chemical Reviews	Russ. Chem. Rev.
Russian Journal of Applied Chemistry	Russ. J. Appl. Chem.
Russian Journal of Bioorganic Chemistry	Russ. J. Bioorg. Chem.
Russian Journal of Coordination Chemistry	Russ. J. Coord. Chem.
Russian Journal of Electrochemistry	Russ. J. Electrochem.
Russian Journal of General Chemistry	Russ. J. Gen. Chem.
Russian Journal of Genetics	Russ. J. Genet.
Russian Journal of Inorganic Chemistry	Russ. J. Inorg. Chem.
Russian Journal of Organic Chemistry	Russ. J. Org. Chem.
Russian Journal of Physical Chemistry A	Russ. J. Phys. Chem. A
Russian Journal of Physical Chemistry B	Russ. J. Phys. Chem. B
Russian Journal of Plant Physiology	Russ. J. Plant Physiol.
SAR and QSAR in Environmental Research	SAR QSAR Environ. Res.
SPE Production & Operations	SPE Prod. Oper.
SPE Reservoir Evaluation & Engineering	SPE Reservoir Eval. Eng.
Science (Washington, DC, United States)	Science (Washington, DC, U. S.)
Science China: Chemistry	Sci. China: Chem.
Science Letters	Sci. Lett.
	Sci. Adv. Mater. Science of Advanced Materials
Science of Synthesis, Knowledge Updates	Sci. Synth., Knowl. Updates
Science of the Total Environment	Sci. Total Environ.
Scientia Pharmaceutica	Sci. Pharm.
Scientific Reports	Sci. Rep.
Scripta Materialia	Scr. Mater.
	Seibutsu Kogaku Kaishi
Semiconductor Science and Technology	Semicond. Sci. Technol.
	Semiconductors
Sensors and Actuators, A: Physical	Sens. Actuators, A
Sensors and Actuators, B: Chemical	Sens. Actuators, B
Separation Science and Technology (Philadelphia, PA, United States)	Sep. Sci. Technol. (Philadelphia, PA, U. S.)
Separation and Purification Technology	Sep. Purif. Technol.
	Sepu
	Shiyou Huagong
	Shiyou Xuebao, Shiyou Jiagong
	Shuichuli Jishu
	Silicon
	Small
	Soft Matter
Soil Biology & Biochemistry	Soil Biol. Biochem.
Soil Science	Soil Sci.
Soil Science Society of America Journal	Soil Sci. Soc. Am. J.
Solar Energy Materials & Solar Cells	Sol. Energy Mater. Sol. Cells
Solid Fuel Chemistry	Solid Fuel Chem.
Solid State Communications	Solid State Commun.
	Solid State Ionics
Solid State Nuclear Magnetic Resonance	Solid State Nucl. Magn. Reson.
Solid State Sciences	Solid State Sci.
Solid-State Electronics	Solid-State Electron.
Solvent Extraction Research and Development, Japan	Solvent Extr. Res. Dev., Jpn.
Solvent Extraction and Ion Exchange	Solvent Extr. Ion Exch.
South African Journal of Chemistry	S. Afr. J. Chem.
Spectrochimica Acta, Part A: Molecular and Biomolecular Spectroscopy	Spectrochim. Acta, Part A
Spectrochimica Acta, Part B: Atomic Spectroscopy	Spectrochim. Acta, Part B
Spectroscopy Letters	Spectrosc. Lett.
	Starch/Staerke
Steel Research International	Steel Res. Int.
	Steroids
Structural Chemistry	Struct. Chem.
Structural Dynamics	Struct. Dyn.
Structure (Oxford, United Kingdom)	Structure (Oxford, U. K.)
Superconductor Science and Technology	Supercond. Sci. Technol.
Superlattices and Microstructures	Superlattices Microstruct.
Supramolecular Chemistry	Supramol. Chem.
Surface Engineering	Surf. Eng.
Surface Review and Letters	Surf. Rev. Lett.
Surface Science	Surf. Sci.
Surface Science Reports	Surf. Sci. Rep.
Surface and Coatings Technology	Surf. Coat. Technol.
Surface and Interface Analysis	Surf. Interface Anal.
Sustainable Chemical Processes	Sustainable Chem. Processes
Synapse (Hoboken, NJ, United States)	Synapse (Hoboken, NJ, U. S.)
	Synlett
	Synthesis
Synthesis and Reactivity in Inorganic, Metal-Organic, and Nano-Metal Chemistry	Synth. React. Inorg., Met.-Org., Nano-Met. Chem.
Synthetic Communications	Synth. Commun.
Synthetic Metals	Synth. Met.
	Taehan Kumsok, Chaeryo Hakhoechi
	Talanta
Tappi Journal	Tappi J.
Technical Physics	Tech. Phys.
Technical Physics Letters	Tech. Phys. Lett.
Tenside, Surfactants, Detergents	Tenside, Surfactants, Deterg.
	Tetrahedron
Tetrahedron Letters	Tetrahedron Lett.
	Tetrahedron: Asymmetry
Textile Research Journal	Text. Res. J.
Theoretical Chemistry Accounts	Theor. Chem. Acc.
Theoretical Foundations of Chemical Engineering	Theor. Found. Chem. Eng.
Theoretical and Experimental Chemistry	Theor. Exp. Chem.
Therapeutic Delivery	Ther. Delivery
Thermochimica Acta	Thermochim. Acta
	Thin Solid Films
Thrombosis Research	Thromb. Res.
Tonkie Khimicheskie Tekhnologii	Tonkie Khim. Tekhnol.
Topics in Catalysis	Top. Catal.
Toxicological & Environmental Chemistry	Toxicol. Environ. Chem.
Toxicological Sciences	Toxicol. Sci.
	Toxicology
Toxicology In Vitro	Toxicol. In Vitro
Toxicology Letters	Toxicol. Lett.
Toxicology Mechanisms and Methods	Toxicol. Mech. Methods
Toxicology Research (Cambridge, United Kingdom)	Toxicol. Res. (Cambridge, U. K.)
Toxicology and Applied Pharmacology	Toxicol. Appl. Pharmacol.
	Toxicon
TrAC, Trends in Analytical Chemistry	TrAC, Trends Anal. Chem.
Traffic (Oxford, United Kingdom)	Traffic (Oxford, U. K.)
Transactions of the Indian Ceramic Society	Trans. Indian Ceram. Soc.
Transactions of the Institute of Metal Finishing	Trans. Inst. Met. Finish.
Transgenic Research	Transgenic Res.
Transition Metal Chemistry (Dordrecht, Netherlands)	Transition Met. Chem. (Dordrecht, Neth.)
Trends in Biochemical Sciences	Trends Biochem. Sci.
Trends in Biotechnology	Trends Biotechnol.
Trends in Carbohydrate Research	Trends Carbohydr. Res.
Trends in Endocrinology and Metabolism	Trends Endocrinol. Metab.
Trends in Environmental Analytical Chemistry	Trends Environ. Anal. Chem.
Trends in Food Science & Technology	Trends Food Sci. Technol.
Trends in Genetics	Trends Genet.
Trends in Immunology	Trends Immunol.
Trends in Microbiology	Trends Microbiol.
Trends in Neurosciences	Trends Neurosci.
Trends in Pharmacological Sciences	Trends Pharmacol. Sci.
Trends in Plant Science	Trends Plant Sci.
Tribology Transactions	Tribol. Trans.
Turkish Journal of Chemistry	Turk. J. Chem.
Ukrainian Biochemical Journal	Ukr. Biochem. J.
Ukrainica Bioorganica Acta	Ukr. Bioorg. Acta
Ukrainskii Khimicheskii Zhurnal (Russian Edition)	Ukr. Khim. Zh. (Russ. Ed.)
	Ultramicroscopy
Ultrasonics Sonochemistry	Ultrason. Sonochem.
	Vacuum
Vascular Pharmacology	Vasc. Pharmacol.
Vestnik Moskovskogo Universiteta, Seriya 2: Khimiya	Vestn. Mosk. Univ., Ser. 2: Khim.
Vestnik Sankt-Peterburgskogo Universiteta, Seriya 4:	Vestn. S.-Peterb. Univ., Ser. 4: Fiz., Khim.
	Fizika, Khimiya
Vestsi Natsyyanal'nai Akademii Navuk Belarusi, Seryya Khimichnykh Navuk	Vestsi Nats. Akad. Navuk Belarusi, Ser. Khim. Navuk
Vibrational Spectroscopy	Vib. Spectrosc.
Viral Immunology	Viral Immunol.
	Virology
	Virus Genes
Virus Research	Virus Res.
Water Environment Research	Water Environ. Res.
Water Quality Research Journal of Canada	Water Qual. Res. J. Can.
Water Research	Water Res.
Water Resources	Water Resour.
Water, Air, & Soil Pollution	Water, Air, Soil Pollut.
	Wear
	Women's Health
Wood Science and Technology	Wood Sci. Technol.
Wood and Fiber Science	Wood Fiber Sci.
World Journal of Condensed Matter Physics	World J. Condens. Matter Phys.
	Wuji Huaxue Xuebao
	Wuli Huaxue Xuebao
	Wuli Xuebao
X-Ray Spectrometry	X-Ray Spectrom.
X-Ray Structure Analysis Online	X-Ray Struct. Anal. Online
	Xenobiotica
	Yakhak Hoechi
	Yakugaku Zasshi
	Yeast
	Yingxiang Kexue Yu Guang Huaxue
	Yingyong Huaxue
	Yosetsu Gakkai Ronbunshu
	Youji Huaxue
	Yuki Gosei Kagaku Kyokaishi
Zeitschrift fuer Anorganische und Allgemeine Chemie	Z. Anorg. Allg. Chem.
Zeitschrift fuer Kristallographie - Crystalline Materials	Z. Kristallogr. - Cryst. Mater.
Zeitschrift fuer Kristallographie - New Crystal Structures	Z. Kristallogr. - New Cryst. Struct.
Zeitschrift fuer Lebensmittel-Untersuchung und -Forschung A: European Food Research and Technology	Z. Lebensm.-Unters. Forsch. A
Zeitschrift fuer Naturforschung, A: Physical Sciences	Z. Naturforsch., A: Phys. Sci.
Zeitschrift fuer Naturforschung, B: A Journal of Chemical Sciences	Z. Naturforsch., B: J. Chem. Sci.
Zeitschrift fuer Naturforschung, C: Journal of Biosciences	Z. Naturforsch., C: J. Biosci.
Zeitschrift fuer Physikalische Chemie (Muenchen, Germany)	Z. Phys. Chem. (Muenchen, Ger.)
	Zhipu Xuebao
	Zhongguo Shengwu Huaxue Yu Fenzi Shengwu Xuebao
	Zhongguo Wuji Fenxi Huaxue
Zhurnal Organichnoi ta Farmatsevtichnoi Khimii	Zh. Org. Farm. Khim.